Id	Print_Name	Inverted_Name
aaa	Ghotuo	Ghotuo
aab	Alumu-Tesu	Alumu-Tesu
aac	Ari	Ari
aad	Amal	Amal
aae	Arbëreshë Albanian	Albanian, Arbëreshë
aaf	Aranadan	Aranadan
aag	Ambrak	Ambrak
aai	Arifama-Miniafia	Arifama-Miniafia
aak	Ankave	Ankave
aal	Afade	Afade
aam	Aramanik	Aramanik
aan	Anambé	Anambé
aao	Algerian Saharan Arabic	Arabic, Algerian Saharan
aap	Pará Arára	Arára, Pará
aaq	Eastern Abnaki	Abnaki, Eastern
aar	Afar	Afar
aas	Aasáx	Aasáx
aat	Arvanitika Albanian	Albanian, Arvanitika
aau	Abau	Abau
aaw	Solong	Solong
aax	Mandobo Atas	Mandobo Atas
aay	Aariya	Aariya
aaz	Amarasi	Amarasi
aba	Abé	Abé
abb	Bankon	Bankon
abc	Ambala Ayta	Ayta, Ambala
abd	Camarines Norte Agta	Agta, Camarines Norte
abe	Western Abnaki	Abnaki, Western
abf	Abai Sungai	Abai Sungai
abg	Abaga	Abaga
abh	Tajiki Arabic	Arabic, Tajiki
abi	Abidji	Abidji
abj	Aka-Bea	Aka-Bea
abk	Abkhazian	Abkhazian
abl	Abung	Abung
abm	Abanyom	Abanyom
abn	Abua	Abua
abo	Abon	Abon
abp	Abenlen Ayta	Ayta, Abenlen
abq	Abaza	Abaza
abr	Abron	Abron
abs	Ambonese Malay	Malay, Ambonese
abt	Ambulas	Ambulas
abu	Abure	Abure
abv	Baharna Arabic	Arabic, Baharna
abw	Pal	Pal
abx	Inabaknon	Inabaknon
aby	Aneme Wake	Aneme Wake
abz	Abui	Abui
aca	Achagua	Achagua
acb	Áncá	Áncá
acc	Cubulco Achí	Achí, Cubulco
acd	Gikyode	Gikyode
ace	Achinese	Achinese
acf	Saint Lucian Creole French	Creole French, Saint Lucian
ach	Acoli	Acoli
aci	Aka-Cari	Aka-Cari
ack	Aka-Kora	Aka-Kora
acl	Akar-Bale	Akar-Bale
acm	Mesopotamian Arabic	Arabic, Mesopotamian
acn	Achang	Achang
acp	Eastern Acipa	Acipa, Eastern
acq	Ta'izzi-Adeni Arabic	Arabic, Ta'izzi-Adeni
acr	Rabinal Achí	Achí, Rabinal
acs	Acroá	Acroá
act	Achterhoeks	Achterhoeks
acu	Achuar-Shiwiar	Achuar-Shiwiar
acv	Achumawi	Achumawi
acw	Hijazi Arabic	Arabic, Hijazi
acx	Omani Arabic	Arabic, Omani
acy	Cypriot Arabic	Arabic, Cypriot
acz	Acheron	Acheron
ada	Adangme	Adangme
adb	Adabe	Adabe
add	Dzodinka	Dzodinka
ade	Adele	Adele
adf	Dhofari Arabic	Arabic, Dhofari
adg	Andegerebinha	Andegerebinha
adh	Adhola	Adhola
adi	Adi	Adi
adj	Adioukrou	Adioukrou
adl	Galo Adi	Adi, Galo
adn	Adang	Adang
ado	Abu	Abu
adp	Adap	Adap
adq	Adangbe	Adangbe
adr	Adonara	Adonara
ads	Adamorobe Sign Language	Adamorobe Sign Language
adt	Adnyamathanha	Adnyamathanha
adu	Aduge	Aduge
adw	Amundava	Amundava
adx	Amdo Tibetan	Tibetan, Amdo
ady	Adygei	Adygei
ady	Adyghe	Adyghe
aea	Areba	Areba
aeb	Tunisian Arabic	Arabic, Tunisian
aec	Saidi Arabic	Arabic, Saidi
aed	Argentine Sign Language	Argentine Sign Language
aee	Northeast Pashayi	Pashayi, Northeast
aek	Haeke	Haeke
ael	Ambele	Ambele
aem	Arem	Arem
aen	Armenian Sign Language	Armenian Sign Language
aeq	Aer	Aer
aer	Eastern Arrernte	Arrernte, Eastern
aes	Alsea	Alsea
aew	Ambakich	Ambakich
aex	Amerax	Amerax
aey	Amele	Amele
afb	Gulf Arabic	Arabic, Gulf
afe	Putukwam	Putukwam
afg	Afghan Sign Language	Afghan Sign Language
afh	Afrihili	Afrihili
afi	Akrukay	Akrukay
afn	Defaka	Defaka
afo	Eloyi	Eloyi
afr	Afrikaans	Afrikaans
afs	Afro-Seminole Creole	Creole, Afro-Seminole
aft	Afitti	Afitti
afu	Awutu	Awutu
afz	Obokuitai	Obokuitai
aga	Aguano	Aguano
agb	Legbo	Legbo
agc	Agatu	Agatu
agd	Agarabi	Agarabi
age	Angal	Angal
agf	Arguni	Arguni
agg	Angor	Angor
agh	Ngelima	Ngelima
agi	Agariya	Agariya
agj	Argobba	Argobba
agk	Isarog Agta	Agta, Isarog
agl	Fembe	Fembe
agm	Angaatiha	Angaatiha
agn	Agutaynen	Agutaynen
ago	Tainae	Tainae
agp	Paranan	Paranan
agq	Aghem	Aghem
agr	Aguaruna	Aguaruna
ags	Esimbi	Esimbi
agt	Central Cagayan Agta	Agta, Central Cagayan
agu	Aguacateco	Aguacateco
agv	Remontado Agta	Agta, Remontado
agw	Kahua	Kahua
agx	Aghul	Aghul
agy	Southern Alta	Alta, Southern
agz	Mt. Iriga Agta	Agta, Mt. Iriga
aha	Ahanta	Ahanta
ahb	Axamb	Axamb
ahe	Ahe	Ahe
ahg	Qimant	Qimant
ahh	Aghu	Aghu
ahi	Tiagbamrin Aizi	Aizi, Tiagbamrin
ahk	Akha	Akha
ahl	Igo	Igo
ahm	Mobumrin Aizi	Aizi, Mobumrin
ahn	Àhàn	Àhàn
aho	Ahom	Ahom
ahp	Aproumu Aizi	Aizi, Aproumu
ahr	Ahirani	Ahirani
ahs	Ashe	Ashe
aht	Ahtena	Ahtena
aia	Arosi	Arosi
aib	Ainu (China)	Ainu (China)
aic	Ainbai	Ainbai
aid	Alngith	Alngith
aie	Amara	Amara
aif	Agi	Agi
aig	Antigua and Barbuda Creole English	Creole English, Antigua and Barbuda
aih	Ai-Cham	Ai-Cham
aii	Assyrian Neo-Aramaic	Neo-Aramaic, Assyrian
aij	Lishanid Noshan	Lishanid Noshan
aik	Ake	Ake
ail	Aimele	Aimele
aim	Aimol	Aimol
ain	Ainu (Japan)	Ainu (Japan)
aio	Aiton	Aiton
aip	Burumakok	Burumakok
aiq	Aimaq	Aimaq
air	Airoran	Airoran
ais	Nataoran Amis	Amis, Nataoran
ait	Arikem	Arikem
aix	Aigon	Aigon
aiy	Ali	Ali
aiz	Aari	Aari
aja	Aja (Sudan)	Aja (Sudan)
ajg	Aja (Benin)	Aja (Benin)
aji	Ajië	Ajië
ajp	South Levantine Arabic	Arabic, South Levantine
ajt	Judeo-Tunisian Arabic	Arabic, Judeo-Tunisian
aju	Judeo-Moroccan Arabic	Arabic, Judeo-Moroccan
ajw	Ajawa	Ajawa
ajz	Amri Karbi	Karbi, Amri
aka	Akan	Akan
akb	Batak Angkola	Batak Angkola
akc	Mpur	Mpur
akd	Ukpet-Ehom	Ukpet-Ehom
ake	Akawaio	Akawaio
akf	Akpa	Akpa
akg	Anakalangu	Anakalangu
akh	Angal Heneng	Angal Heneng
aki	Aiome	Aiome
akj	Aka-Jeru	Aka-Jeru
akk	Akkadian	Akkadian
akl	Aklanon	Aklanon
akm	Aka-Bo	Aka-Bo
akn	Amikoana	Amikoana
ako	Akurio	Akurio
akp	Siwu	Siwu
akq	Ak	Ak
akr	Araki	Araki
aks	Akaselem	Akaselem
akt	Akolet	Akolet
aku	Akum	Akum
akv	Akhvakh	Akhvakh
akw	Akwa	Akwa
akx	Aka-Kede	Aka-Kede
aky	Aka-Kol	Aka-Kol
akz	Alabama	Alabama
ala	Alago	Alago
alc	Qawasqar	Qawasqar
ald	Alladian	Alladian
ale	Aleut	Aleut
alf	Alege	Alege
alh	Alawa	Alawa
ali	Amaimon	Amaimon
alj	Alangan	Alangan
alk	Alak	Alak
all	Allar	Allar
alm	Amblong	Amblong
aln	Gheg Albanian	Albanian, Gheg
alo	Larike-Wakasihu	Larike-Wakasihu
alp	Alune	Alune
alq	Algonquin	Algonquin
alr	Alutor	Alutor
als	Tosk Albanian	Albanian, Tosk
alt	Southern Altai	Altai, Southern
alu	'Are'are	'Are'are
alw	Alaba	Alaba
alx	Amol	Amol
aly	Alyawarr	Alyawarr
alz	Alur	Alur
ama	Amanayé	Amanayé
amb	Ambo	Ambo
amc	Amahuaca	Amahuaca
ame	Yanesha'	Yanesha'
amf	Hamer-Banna	Hamer-Banna
amg	Amarag	Amarag
amh	Amharic	Amharic
ami	Amis	Amis
amj	Amdang	Amdang
amk	Ambai	Ambai
aml	War-Jaintia	War-Jaintia
amm	Ama (Papua New Guinea)	Ama (Papua New Guinea)
amn	Amanab	Amanab
amo	Amo	Amo
amp	Alamblak	Alamblak
amq	Amahai	Amahai
amr	Amarakaeri	Amarakaeri
ams	Southern Amami-Oshima	Amami-Oshima, Southern
amt	Amto	Amto
amu	Guerrero Amuzgo	Amuzgo, Guerrero
amv	Ambelau	Ambelau
amw	Western Neo-Aramaic	Neo-Aramaic, Western
amx	Anmatyerre	Anmatyerre
amy	Ami	Ami
amz	Atampaya	Atampaya
ana	Andaqui	Andaqui
anb	Andoa	Andoa
anc	Ngas	Ngas
and	Ansus	Ansus
ane	Xârâcùù	Xârâcùù
anf	Animere	Animere
ang	Old English (ca. 450-1100)	English, Old (ca. 450-1100)
anh	Nend	Nend
ani	Andi	Andi
anj	Anor	Anor
ank	Goemai	Goemai
anl	Anu	Anu
anm	Anal	Anal
ann	Obolo	Obolo
ano	Andoque	Andoque
anp	Angika	Angika
anq	Jarawa (India)	Jarawa (India)
anr	Andh	Andh
ans	Anserma	Anserma
ant	Antakarinya	Antakarinya
anu	Anuak	Anuak
anv	Denya	Denya
anw	Anaang	Anaang
anx	Andra-Hus	Andra-Hus
any	Anyin	Anyin
anz	Anem	Anem
aoa	Angolar	Angolar
aob	Abom	Abom
aoc	Pemon	Pemon
aod	Andarum	Andarum
aoe	Angal Enen	Angal Enen
aof	Bragat	Bragat
aog	Angoram	Angoram
aoh	Arma	Arma
aoi	Anindilyakwa	Anindilyakwa
aoj	Mufian	Mufian
aok	Arhö	Arhö
aol	Alor	Alor
aom	Ömie	Ömie
aon	Bumbita Arapesh	Arapesh, Bumbita
aor	Aore	Aore
aos	Taikat	Taikat
aot	A'tong	A'tong
aox	Atorada	Atorada
aoz	Uab Meto	Uab Meto
apb	Sa'a	Sa'a
apc	North Levantine Arabic	Arabic, North Levantine
apd	Sudanese Arabic	Arabic, Sudanese
ape	Bukiyip	Bukiyip
apg	Ampanang	Ampanang
aph	Athpariya	Athpariya
api	Apiaká	Apiaká
apj	Jicarilla Apache	Apache, Jicarilla
apk	Kiowa Apache	Apache, Kiowa
apl	Lipan Apache	Apache, Lipan
apm	Mescalero-Chiricahua Apache	Apache, Mescalero-Chiricahua
apn	Apinayé	Apinayé
apo	Apalik	Apalik
app	Apma	Apma
apq	A-Pucikwar	A-Pucikwar
apr	Arop-Lukep	Arop-Lukep
aps	Arop-Sissano	Arop-Sissano
apt	Apatani	Apatani
apu	Apurinã	Apurinã
apw	Western Apache	Apache, Western
apx	Aputai	Aputai
apy	Apalaí	Apalaí
apz	Safeyoka	Safeyoka
aqc	Archi	Archi
aqg	Arigidi	Arigidi
aqm	Atohwaim	Atohwaim
aqn	Northern Alta	Alta, Northern
aqp	Atakapa	Atakapa
aqr	Arhâ	Arhâ
ara	Arabic	Arabic
arb	Standard Arabic	Arabic, Standard
arc	Imperial Aramaic (700-300 BCE)	Aramaic, Imperial (700-300 BCE)
arc	Official Aramaic (700-300 BCE)	Aramaic, Official (700-300 BCE)
ard	Arabana	Arabana
are	Western Arrarnta	Arrarnta, Western
arf	Arafundi	Arafundi
arg	Aragonese	Aragonese
arh	Arhuaco	Arhuaco
ari	Arikara	Arikara
arj	Arapaso	Arapaso
ark	Arikapú	Arikapú
arl	Arabela	Arabela
arn	Mapuche	Mapuche
arn	Mapudungun	Mapudungun
aro	Araona	Araona
arp	Arapaho	Arapaho
arq	Algerian Arabic	Arabic, Algerian
arr	Karo (Brazil)	Karo (Brazil)
ars	Najdi Arabic	Arabic, Najdi
aru	Arua	Arua
arv	Arbore	Arbore
arw	Arawak	Arawak
arx	Aruá	Aruá
ary	Moroccan Arabic	Arabic, Moroccan
arz	Egyptian Arabic	Arabic, Egyptian
asa	Asu (Tanzania)	Asu (Tanzania)
asb	Assiniboine	Assiniboine
asc	Casuarina Coast Asmat	Asmat, Casuarina Coast
asd	Asas	Asas
ase	American Sign Language	American Sign Language
asf	Australian Sign Language	Australian Sign Language
asg	Cishingini	Cishingini
ash	Abishira	Abishira
asi	Buruwai	Buruwai
asj	Nsari	Nsari
ask	Ashkun	Ashkun
asl	Asilulu	Asilulu
asm	Assamese	Assamese
asn	Xingú Asuriní	Asuriní, Xingú
aso	Dano	Dano
asp	Algerian Sign Language	Algerian Sign Language
asq	Austrian Sign Language	Austrian Sign Language
asr	Asuri	Asuri
ass	Ipulo	Ipulo
ast	Asturian	Asturian
ast	Asturleonese	Asturleonese
ast	Bable	Bable
ast	Leonese	Leonese
asu	Tocantins Asurini	Asurini, Tocantins
asv	Asoa	Asoa
asw	Australian Aborigines Sign Language	Australian Aborigines Sign Language
asx	Muratayak	Muratayak
asy	Yaosakor Asmat	Asmat, Yaosakor
asz	As	As
ata	Pele-Ata	Pele-Ata
atb	Zaiwa	Zaiwa
atc	Atsahuaca	Atsahuaca
atd	Ata Manobo	Manobo, Ata
ate	Atemble	Atemble
atg	Ivbie North-Okpela-Arhe	Ivbie North-Okpela-Arhe
ati	Attié	Attié
atj	Atikamekw	Atikamekw
atk	Ati	Ati
atl	Mt. Iraya Agta	Agta, Mt. Iraya
atm	Ata	Ata
atn	Ashtiani	Ashtiani
ato	Atong	Atong
atp	Pudtol Atta	Atta, Pudtol
atq	Aralle-Tabulahan	Aralle-Tabulahan
atr	Waimiri-Atroari	Waimiri-Atroari
ats	Gros Ventre	Gros Ventre
att	Pamplona Atta	Atta, Pamplona
atu	Reel	Reel
atv	Northern Altai	Altai, Northern
atw	Atsugewi	Atsugewi
atx	Arutani	Arutani
aty	Aneityum	Aneityum
atz	Arta	Arta
aua	Asumboa	Asumboa
auc	Waorani	Waorani
aud	Anuta	Anuta
aue	=/Kx'au//'ein	=/Kx'au//'ein
aug	Aguna	Aguna
auh	Aushi	Aushi
aui	Anuki	Anuki
auj	Awjilah	Awjilah
auk	Heyo	Heyo
aul	Aulua	Aulua
aum	Asu (Nigeria)	Asu (Nigeria)
aun	Molmo One	One, Molmo
auo	Auyokawa	Auyokawa
aup	Makayam	Makayam
auq	Anus	Anus
aur	Aruek	Aruek
aut	Austral	Austral
auu	Auye	Auye
auw	Awyi	Awyi
aux	Aurá	Aurá
auy	Awiyaana	Awiyaana
auz	Uzbeki Arabic	Arabic, Uzbeki
ava	Avaric	Avaric
avb	Avau	Avau
avd	Alviri-Vidari	Alviri-Vidari
ave	Avestan	Avestan
avi	Avikam	Avikam
avl	Eastern Egyptian Bedawi Arabic	Arabic, Eastern Egyptian Bedawi
avn	Avatime	Avatime
avo	Agavotaguerra	Agavotaguerra
avs	Aushiri	Aushiri
avt	Au	Au
avu	Avokaya	Avokaya
avv	Avá-Canoeiro	Avá-Canoeiro
awa	Awadhi	Awadhi
awb	Awa	Awa
awc	Western Acipa	Acipa, Western
awe	Awetí	Awetí
awh	Awbono	Awbono
awi	Aekyom	Aekyom
awk	Awabakal	Awabakal
awm	Arawum	Arawum
awn	Awngi	Awngi
awo	Awak	Awak
awr	Awera	Awera
aws	South Awyu	Awyu, South
awt	Araweté	Araweté
awu	Central Awyu	Awyu, Central
awv	Jair Awyu	Awyu, Jair
aww	Awun	Awun
awx	Awara	Awara
awy	Edera Awyu	Awyu, Edera
axb	Abipon	Abipon
axg	Mato Grosso Arára	Arára, Mato Grosso
axk	Yaka (Central African Republic)	Yaka (Central African Republic)
axm	Middle Armenian	Armenian, Middle
axx	Xaragure	Xaragure
aya	Awar	Awar
ayb	Ayizo Gbe	Gbe, Ayizo
ayc	Southern Aymara	Aymara, Southern
ayd	Ayabadhu	Ayabadhu
aye	Ayere	Ayere
ayg	Ginyanga	Ginyanga
ayh	Hadrami Arabic	Arabic, Hadrami
ayi	Leyigha	Leyigha
ayk	Akuku	Akuku
ayl	Libyan Arabic	Arabic, Libyan
aym	Aymara	Aymara
ayn	Sanaani Arabic	Arabic, Sanaani
ayo	Ayoreo	Ayoreo
ayp	North Mesopotamian Arabic	Arabic, North Mesopotamian
ayq	Ayi (Papua New Guinea)	Ayi (Papua New Guinea)
ayr	Central Aymara	Aymara, Central
ays	Sorsogon Ayta	Ayta, Sorsogon
ayt	Bataan Ayta	Ayta, Bataan
ayu	Ayu	Ayu
ayx	Ayi (China)	Ayi (China)
ayy	Tayabas Ayta	Ayta, Tayabas
ayz	Mai Brat	Mai Brat
azb	South Azerbaijani	Azerbaijani, South
aze	Azerbaijani	Azerbaijani
azg	San Pedro Amuzgos Amuzgo	Amuzgo, San Pedro Amuzgos
azj	North Azerbaijani	Azerbaijani, North
azm	Ipalapa Amuzgo	Amuzgo, Ipalapa
azo	Awing	Awing
azr	Adzera	Adzera
azt	Faire Atta	Atta, Faire
azz	Highland Puebla Nahuatl	Nahuatl, Highland Puebla
baa	Babatana	Babatana
bab	Bainouk-Gunyuño	Bainouk-Gunyuño
bac	Badui	Badui
bae	Baré	Baré
baf	Nubaca	Nubaca
bag	Tuki	Tuki
bah	Bahamas Creole English	Creole English, Bahamas
baj	Barakai	Barakai
bak	Bashkir	Bashkir
bal	Baluchi	Baluchi
bam	Bambara	Bambara
ban	Balinese	Balinese
bao	Waimaha	Waimaha
bap	Bantawa	Bantawa
bar	Bavarian	Bavarian
bas	Basa (Cameroon)	Basa (Cameroon)
bau	Bada (Nigeria)	Bada (Nigeria)
bav	Vengo	Vengo
baw	Bambili-Bambui	Bambili-Bambui
bax	Bamun	Bamun
bay	Batuley	Batuley
baz	Tunen	Tunen
bba	Baatonum	Baatonum
bbb	Barai	Barai
bbc	Batak Toba	Batak Toba
bbd	Bau	Bau
bbe	Bangba	Bangba
bbf	Baibai	Baibai
bbg	Barama	Barama
bbh	Bugan	Bugan
bbi	Barombi	Barombi
bbj	Ghomálá'	Ghomálá'
bbk	Babanki	Babanki
bbl	Bats	Bats
bbm	Babango	Babango
bbn	Uneapa	Uneapa
bbo	Northern Bobo Madaré	Bobo Madaré, Northern
bbp	West Central Banda	Banda, West Central
bbq	Bamali	Bamali
bbr	Girawa	Girawa
bbs	Bakpinka	Bakpinka
bbt	Mburku	Mburku
bbu	Kulung (Nigeria)	Kulung (Nigeria)
bbv	Karnai	Karnai
bbw	Baba	Baba
bbx	Bubia	Bubia
bby	Befang	Befang
bbz	Babalia Creole Arabic	Creole Arabic, Babalia
bca	Central Bai	Bai, Central
bcb	Bainouk-Samik	Bainouk-Samik
bcc	Southern Balochi	Balochi, Southern
bcd	North Babar	Babar, North
bce	Bamenyam	Bamenyam
bcf	Bamu	Bamu
bcg	Baga Binari	Baga Binari
bch	Bariai	Bariai
bci	Baoulé	Baoulé
bcj	Bardi	Bardi
bck	Bunaba	Bunaba
bcl	Central Bicolano	Bicolano, Central
bcm	Bannoni	Bannoni
bcn	Bali (Nigeria)	Bali (Nigeria)
bco	Kaluli	Kaluli
bcp	Bali (Democratic Republic of Congo)	Bali (Democratic Republic of Congo)
bcq	Bench	Bench
bcr	Babine	Babine
bcs	Kohumono	Kohumono
bct	Bendi	Bendi
bcu	Awad Bing	Awad Bing
bcv	Shoo-Minda-Nye	Shoo-Minda-Nye
bcw	Bana	Bana
bcx	Pamona	Pamona
bcy	Bacama	Bacama
bcz	Bainouk-Gunyaamolo	Bainouk-Gunyaamolo
bda	Bayot	Bayot
bdb	Basap	Basap
bdc	Emberá-Baudó	Emberá-Baudó
bdd	Bunama	Bunama
bde	Bade	Bade
bdg	Bonggi	Bonggi
bdh	Baka (Sudan)	Baka (Sudan)
bdi	Burun	Burun
bdj	Bai	Bai
bdk	Budukh	Budukh
bdl	Indonesian Bajau	Bajau, Indonesian
bdm	Buduma	Buduma
bdn	Baldemu	Baldemu
bdo	Bernde	Bernde
bdp	Bende	Bende
bdq	Bahnar	Bahnar
bdr	West Coast Bajau	Bajau, West Coast
bds	Burunge	Burunge
bdt	Bokoto	Bokoto
bdu	Oroko	Oroko
bdv	Bodo Parja	Bodo Parja
bdw	Baham	Baham
bdx	Budong-Budong	Budong-Budong
bdy	Bandjalang	Bandjalang
bdz	Badeshi	Badeshi
bea	Beaver	Beaver
beb	Bebele	Bebele
bec	Iceve-Maci	Iceve-Maci
bed	Bedoanas	Bedoanas
bee	Byangsi	Byangsi
bef	Benabena	Benabena
beg	Belait	Belait
beh	Biali	Biali
bei	Bekati'	Bekati'
bej	Beja	Beja
bek	Bebeli	Bebeli
bel	Belarusian	Belarusian
bem	Bemba (Zambia)	Bemba (Zambia)
ben	Bengali	Bengali
beo	Beami	Beami
bep	Besoa	Besoa
beq	Beembe	Beembe
bes	Besme	Besme
bet	Guiberoua Béte	Béte, Guiberoua
beu	Blagar	Blagar
bev	Daloa Bété	Bété, Daloa
bew	Betawi	Betawi
bex	Jur Modo	Jur Modo
bey	Beli (Papua New Guinea)	Beli (Papua New Guinea)
bez	Bena (Tanzania)	Bena (Tanzania)
bfa	Bari	Bari
bfb	Pauri Bareli	Bareli, Pauri
bfc	Northern Bai	Bai, Northern
bfd	Bafut	Bafut
bfe	Betaf	Betaf
bff	Bofi	Bofi
bfg	Busang Kayan	Kayan, Busang
bfh	Blafe	Blafe
bfi	British Sign Language	British Sign Language
bfj	Bafanji	Bafanji
bfk	Ban Khor Sign Language	Ban Khor Sign Language
bfl	Banda-Ndélé	Banda-Ndélé
bfm	Mmen	Mmen
bfn	Bunak	Bunak
bfo	Malba Birifor	Birifor, Malba
bfp	Beba	Beba
bfq	Badaga	Badaga
bfr	Bazigar	Bazigar
bfs	Southern Bai	Bai, Southern
bft	Balti	Balti
bfu	Gahri	Gahri
bfw	Bondo	Bondo
bfy	Bagheli	Bagheli
bfz	Mahasu Pahari	Pahari, Mahasu
bga	Gwamhi-Wuri	Gwamhi-Wuri
bgb	Bobongko	Bobongko
bgc	Haryanvi	Haryanvi
bgd	Rathwi Bareli	Bareli, Rathwi
bge	Bauria	Bauria
bgf	Bangandu	Bangandu
bgg	Bugun	Bugun
bgi	Giangan	Giangan
bgj	Bangolan	Bangolan
bgk	Bit	Bit
bgl	Bo (Laos)	Bo (Laos)
bgm	Baga Mboteni	Baga Mboteni
bgn	Western Balochi	Balochi, Western
bgo	Baga Koga	Baga Koga
bgp	Eastern Balochi	Balochi, Eastern
bgq	Bagri	Bagri
bgr	Bawm Chin	Chin, Bawm
bgs	Tagabawa	Tagabawa
bgt	Bughotu	Bughotu
bgu	Mbongno	Mbongno
bgv	Warkay-Bipim	Warkay-Bipim
bgw	Bhatri	Bhatri
bgx	Balkan Gagauz Turkish	Turkish, Balkan Gagauz
bgy	Benggoi	Benggoi
bgz	Banggai	Banggai
bha	Bharia	Bharia
bhb	Bhili	Bhili
bhc	Biga	Biga
bhd	Bhadrawahi	Bhadrawahi
bhe	Bhaya	Bhaya
bhf	Odiai	Odiai
bhg	Binandere	Binandere
bhh	Bukharic	Bukharic
bhi	Bhilali	Bhilali
bhj	Bahing	Bahing
bhk	Albay Bicolano	Bicolano, Albay
bhl	Bimin	Bimin
bhm	Bathari	Bathari
bhn	Bohtan Neo-Aramaic	Neo-Aramaic, Bohtan
bho	Bhojpuri	Bhojpuri
bhp	Bima	Bima
bhq	Tukang Besi South	Tukang Besi South
bhr	Bara Malagasy	Malagasy, Bara
bhs	Buwal	Buwal
bht	Bhattiyali	Bhattiyali
bhu	Bhunjia	Bhunjia
bhv	Bahau	Bahau
bhw	Biak	Biak
bhx	Bhalay	Bhalay
bhy	Bhele	Bhele
bhz	Bada (Indonesia)	Bada (Indonesia)
bia	Badimaya	Badimaya
bib	Bissa	Bissa
bic	Bikaru	Bikaru
bid	Bidiyo	Bidiyo
bie	Bepour	Bepour
bif	Biafada	Biafada
big	Biangai	Biangai
bii	Bisu	Bisu
bij	Vaghat-Ya-Bijim-Legeri	Vaghat-Ya-Bijim-Legeri
bik	Bikol	Bikol
bil	Bile	Bile
bim	Bimoba	Bimoba
bin	Bini	Bini
bin	Edo	Edo
bio	Nai	Nai
bip	Bila	Bila
biq	Bipi	Bipi
bir	Bisorio	Bisorio
bis	Bislama	Bislama
bit	Berinomo	Berinomo
biu	Biete	Biete
biv	Southern Birifor	Birifor, Southern
biw	Kol (Cameroon)	Kol (Cameroon)
bix	Bijori	Bijori
biy	Birhor	Birhor
biz	Baloi	Baloi
bja	Budza	Budza
bjb	Banggarla	Banggarla
bjc	Bariji	Bariji
bjd	Bandjigali	Bandjigali
bje	Biao-Jiao Mien	Mien, Biao-Jiao
bjf	Barzani Jewish Neo-Aramaic	Neo-Aramaic, Barzani Jewish
bjg	Bidyogo	Bidyogo
bjh	Bahinemo	Bahinemo
bji	Burji	Burji
bjj	Kanauji	Kanauji
bjk	Barok	Barok
bjl	Bulu (Papua New Guinea)	Bulu (Papua New Guinea)
bjm	Bajelani	Bajelani
bjn	Banjar	Banjar
bjo	Mid-Southern Banda	Banda, Mid-Southern
bjq	Southern Betsimisaraka Malagasy	Malagasy, Southern Betsimisaraka
bjr	Binumarien	Binumarien
bjs	Bajan	Bajan
bjt	Balanta-Ganja	Balanta-Ganja
bju	Busuu	Busuu
bjv	Bedjond	Bedjond
bjw	Bakwé	Bakwé
bjx	Banao Itneg	Itneg, Banao
bjy	Bayali	Bayali
bjz	Baruga	Baruga
bka	Kyak	Kyak
bkb	Finallig	Finallig
bkc	Baka (Cameroon)	Baka (Cameroon)
bkd	Binukid	Binukid
bke	Bengkulu	Bengkulu
bkf	Beeke	Beeke
bkg	Buraka	Buraka
bkh	Bakoko	Bakoko
bki	Baki	Baki
bkj	Pande	Pande
bkk	Brokskat	Brokskat
bkl	Berik	Berik
bkm	Kom (Cameroon)	Kom (Cameroon)
bkn	Bukitan	Bukitan
bko	Kwa'	Kwa'
bkp	Boko (Democratic Republic of Congo)	Boko (Democratic Republic of Congo)
bkq	Bakairí	Bakairí
bkr	Bakumpai	Bakumpai
bks	Masbate Sorsogon	Sorsogon, Masbate
bkt	Boloki	Boloki
bku	Buhid	Buhid
bkv	Bekwarra	Bekwarra
bkw	Bekwil	Bekwil
bkx	Baikeno	Baikeno
bky	Bokyi	Bokyi
bkz	Bungku	Bungku
bla	Siksika	Siksika
blb	Bilua	Bilua
blc	Bella Coola	Bella Coola
bld	Bolango	Bolango
ble	Balanta-Kentohe	Balanta-Kentohe
blf	Buol	Buol
blg	Balau	Balau
blh	Kuwaa	Kuwaa
bli	Bolia	Bolia
blj	Bolongan	Bolongan
blk	Pa'o Karen	Karen, Pa'o
bll	Biloxi	Biloxi
blm	Beli (Sudan)	Beli (Sudan)
bln	Southern Catanduanes Bicolano	Bicolano, Southern Catanduanes
blo	Anii	Anii
blp	Blablanga	Blablanga
blq	Baluan-Pam	Baluan-Pam
blr	Blang	Blang
bls	Balaesang	Balaesang
blt	Tai Dam	Tai Dam
blu	Hmong Njua	Hmong Njua
blv	Bolo	Bolo
blw	Balangao	Balangao
blx	Mag-Indi Ayta	Ayta, Mag-Indi
bly	Notre	Notre
blz	Balantak	Balantak
bma	Lame	Lame
bmb	Bembe	Bembe
bmc	Biem	Biem
bmd	Baga Manduri	Manduri, Baga
bme	Limassa	Limassa
bmf	Bom	Bom
bmg	Bamwe	Bamwe
bmh	Kein	Kein
bmi	Bagirmi	Bagirmi
bmj	Bote-Majhi	Bote-Majhi
bmk	Ghayavi	Ghayavi
bml	Bomboli	Bomboli
bmm	Northern Betsimisaraka Malagasy	Malagasy, Northern Betsimisaraka
bmn	Bina (Papua New Guinea)	Bina (Papua New Guinea)
bmo	Bambalang	Bambalang
bmp	Bulgebi	Bulgebi
bmq	Bomu	Bomu
bmr	Muinane	Muinane
bms	Bilma Kanuri	Kanuri, Bilma
bmt	Biao Mon	Biao Mon
bmu	Burum-Mindik	Burum-Mindik
bmv	Bum	Bum
bmw	Bomwali	Bomwali
bmx	Baimak	Baimak
bmy	Bemba (Democratic Republic of Congo)	Bemba (Democratic Republic of Congo)
bmz	Baramu	Baramu
bna	Bonerate	Bonerate
bnb	Bookan	Bookan
bnc	Central Bontoc	Bontoc, Central
bnd	Banda (Indonesia)	Banda (Indonesia)
bne	Bintauna	Bintauna
bnf	Masiwang	Masiwang
bng	Benga	Benga
bni	Bangi	Bangi
bnj	Eastern Tawbuid	Tawbuid, Eastern
bnk	Bierebo	Bierebo
bnl	Boon	Boon
bnm	Batanga	Batanga
bnn	Bunun	Bunun
bno	Bantoanon	Bantoanon
bnp	Bola	Bola
bnq	Bantik	Bantik
bnr	Butmas-Tur	Butmas-Tur
bns	Bundeli	Bundeli
bnu	Bentong	Bentong
bnv	Bonerif	Bonerif
bnw	Bisis	Bisis
bnx	Bangubangu	Bangubangu
bny	Bintulu	Bintulu
bnz	Beezen	Beezen
boa	Bora	Bora
bob	Aweer	Aweer
boc	Bakung Kenyah	Kenyah, Bakung
bod	Tibetan	Tibetan
boe	Mundabli	Mundabli
bof	Bolon	Bolon
bog	Bamako Sign Language	Bamako Sign Language
boh	Boma	Boma
boi	Barbareño	Barbareño
boj	Anjam	Anjam
bok	Bonjo	Bonjo
bol	Bole	Bole
bom	Berom	Berom
bon	Bine	Bine
boo	Tiemacèwè Bozo	Bozo, Tiemacèwè
bop	Bonkiman	Bonkiman
boq	Bogaya	Bogaya
bor	Borôro	Borôro
bos	Bosnian	Bosnian
bot	Bongo	Bongo
bou	Bondei	Bondei
bov	Tuwuli	Tuwuli
bow	Rema	Rema
box	Buamu	Buamu
boy	Bodo (Central African Republic)	Bodo (Central African Republic)
boz	Tiéyaxo Bozo	Bozo, Tiéyaxo
bpa	Dakaka	Dakaka
bpb	Barbacoas	Barbacoas
bpd	Banda-Banda	Banda-Banda
bpg	Bonggo	Bonggo
bph	Botlikh	Botlikh
bpi	Bagupi	Bagupi
bpj	Binji	Binji
bpk	Orowe	Orowe
bpl	Broome Pearling Lugger Pidgin	Broome Pearling Lugger Pidgin
bpm	Biyom	Biyom
bpn	Dzao Min	Dzao Min
bpo	Anasi	Anasi
bpp	Kaure	Kaure
bpq	Banda Malay	Malay, Banda
bpr	Koronadal Blaan	Blaan, Koronadal
bps	Sarangani Blaan	Blaan, Sarangani
bpt	Barrow Point	Barrow Point
bpu	Bongu	Bongu
bpv	Bian Marind	Marind, Bian
bpw	Bo (Papua New Guinea)	Bo (Papua New Guinea)
bpx	Palya Bareli	Bareli, Palya
bpy	Bishnupriya	Bishnupriya
bpz	Bilba	Bilba
bqa	Tchumbuli	Tchumbuli
bqb	Bagusa	Bagusa
bqc	Boko (Benin)	Boko (Benin)
bqd	Bung	Bung
bqf	Baga Kaloum	Baga Kaloum
bqg	Bago-Kusuntu	Bago-Kusuntu
bqh	Baima	Baima
bqi	Bakhtiari	Bakhtiari
bqj	Bandial	Bandial
bqk	Banda-Mbrès	Banda-Mbrès
bql	Bilakura	Bilakura
bqm	Wumboko	Wumboko
bqn	Bulgarian Sign Language	Bulgarian Sign Language
bqo	Balo	Balo
bqp	Busa	Busa
bqq	Biritai	Biritai
bqr	Burusu	Burusu
bqs	Bosngun	Bosngun
bqt	Bamukumbit	Bamukumbit
bqu	Boguru	Boguru
bqv	Begbere-Ejar	Begbere-Ejar
bqw	Buru (Nigeria)	Buru (Nigeria)
bqx	Baangi	Baangi
bqy	Bali Sign Language	Bali Sign Language
bqz	Bakaka	Bakaka
bra	Braj	Braj
brb	Lave	Lave
brc	Berbice Creole Dutch	Creole Dutch, Berbice
brd	Baraamu	Baraamu
bre	Breton	Breton
brf	Bera	Bera
brg	Baure	Baure
brh	Brahui	Brahui
bri	Mokpwe	Mokpwe
brj	Bieria	Bieria
brk	Birked	Birked
brl	Birwa	Birwa
brm	Barambu	Barambu
brn	Boruca	Boruca
bro	Brokkat	Brokkat
brp	Barapasi	Barapasi
brq	Breri	Breri
brr	Birao	Birao
brs	Baras	Baras
brt	Bitare	Bitare
bru	Eastern Bru	Bru, Eastern
brv	Western Bru	Bru, Western
brw	Bellari	Bellari
brx	Bodo (India)	Bodo (India)
bry	Burui	Burui
brz	Bilbil	Bilbil
bsa	Abinomn	Abinomn
bsb	Brunei Bisaya	Bisaya, Brunei
bsc	Bassari	Bassari
bsd	Sarawak Bisaya	Bisaya, Sarawak
bse	Wushi	Wushi
bsf	Bauchi	Bauchi
bsg	Bashkardi	Bashkardi
bsh	Kati	Kati
bsi	Bassossi	Bassossi
bsj	Bangwinji	Bangwinji
bsk	Burushaski	Burushaski
bsl	Basa-Gumna	Basa-Gumna
bsm	Busami	Busami
bsn	Barasana-Eduria	Barasana-Eduria
bso	Buso	Buso
bsp	Baga Sitemu	Baga Sitemu
bsq	Bassa	Bassa
bsr	Bassa-Kontagora	Bassa-Kontagora
bss	Akoose	Akoose
bst	Basketo	Basketo
bsu	Bahonsuai	Bahonsuai
bsv	Baga Sobané	Baga Sobané
bsw	Baiso	Baiso
bsx	Yangkam	Yangkam
bsy	Sabah Bisaya	Bisaya, Sabah
bta	Bata	Bata
btb	Beti (Cameroon)	Beti (Cameroon)
btc	Bati (Cameroon)	Bati (Cameroon)
btd	Batak Dairi	Batak Dairi
bte	Gamo-Ningi	Gamo-Ningi
btf	Birgit	Birgit
btg	Gagnoa Bété	Bété, Gagnoa
bth	Biatah	Biatah
bti	Burate	Burate
btj	Bacanese Malay	Malay, Bacanese
btl	Bhatola	Bhatola
btm	Batak Mandailing	Batak Mandailing
btn	Ratagnon	Ratagnon
bto	Iriga Bicolano	Bicolano, Iriga
btp	Budibud	Budibud
btq	Batek	Batek
btr	Baetora	Baetora
bts	Batak Simalungun	Batak Simalungun
btt	Bete-Bendi	Bete-Bendi
btu	Batu	Batu
btv	Bateri	Bateri
btw	Butuanon	Butuanon
btx	Batak Karo	Batak Karo
bty	Bobot	Bobot
btz	Batak Alas-Kluet	Batak Alas-Kluet
bua	Buriat	Buriat
bub	Bua	Bua
buc	Bushi	Bushi
bud	Ntcham	Ntcham
bue	Beothuk	Beothuk
buf	Bushoong	Bushoong
bug	Buginese	Buginese
buh	Younuo Bunu	Bunu, Younuo
bui	Bongili	Bongili
buj	Basa-Gurmana	Basa-Gurmana
buk	Bugawac	Bugawac
bul	Bulgarian	Bulgarian
bum	Bulu (Cameroon)	Bulu (Cameroon)
bun	Sherbro	Sherbro
buo	Terei	Terei
bup	Busoa	Busoa
buq	Brem	Brem
bus	Bokobaru	Bokobaru
but	Bungain	Bungain
buu	Budu	Budu
buv	Bun	Bun
buw	Bubi	Bubi
bux	Boghom	Boghom
buy	Bullom So	Bullom So
buz	Bukwen	Bukwen
bva	Barein	Barein
bvb	Bube	Bube
bvc	Baelelea	Baelelea
bvd	Baeggu	Baeggu
bve	Berau Malay	Malay, Berau
bvf	Boor	Boor
bvg	Bonkeng	Bonkeng
bvh	Bure	Bure
bvi	Belanda Viri	Belanda Viri
bvj	Baan	Baan
bvk	Bukat	Bukat
bvl	Bolivian Sign Language	Bolivian Sign Language
bvm	Bamunka	Bamunka
bvn	Buna	Buna
bvo	Bolgo	Bolgo
bvq	Birri	Birri
bvr	Burarra	Burarra
bvt	Bati (Indonesia)	Bati (Indonesia)
bvu	Bukit Malay	Malay, Bukit
bvv	Baniva	Baniva
bvw	Boga	Boga
bvx	Dibole	Dibole
bvz	Bauzi	Bauzi
bwa	Bwatoo	Bwatoo
bwb	Namosi-Naitasiri-Serua	Namosi-Naitasiri-Serua
bwc	Bwile	Bwile
bwd	Bwaidoka	Bwaidoka
bwe	Bwe Karen	Karen, Bwe
bwf	Boselewa	Boselewa
bwg	Barwe	Barwe
bwh	Bishuo	Bishuo
bwi	Baniwa	Baniwa
bwj	Láá Láá Bwamu	Bwamu, Láá Láá
bwk	Bauwaki	Bauwaki
bwl	Bwela	Bwela
bwm	Biwat	Biwat
bwn	Wunai Bunu	Bunu, Wunai
bwo	Boro	Boro
bwp	Mandobo Bawah	Mandobo Bawah
bwq	Southern Bobo Madaré	Bobo Madaré, Southern
bwr	Bura-Pabir	Bura-Pabir
bws	Bomboma	Bomboma
bwt	Bafaw-Balong	Bafaw-Balong
bwu	Buli (Ghana)	Buli (Ghana)
bwv	Bahau River Kenyah	Kenyah, Bahau River
bww	Bwa	Bwa
bwx	Bu-Nao Bunu	Bunu, Bu-Nao
bwy	Cwi Bwamu	Bwamu, Cwi
bwz	Bwisi	Bwisi
bxa	Bauro	Bauro
bxb	Belanda Bor	Bor, Belanda
bxc	Molengue	Molengue
bxd	Pela	Pela
bxe	Birale	Birale
bxf	Bilur	Bilur
bxg	Bangala	Bangala
bxh	Buhutu	Buhutu
bxi	Pirlatapa	Pirlatapa
bxj	Bayungu	Bayungu
bxk	Bukusu	Bukusu
bxl	Jalkunan	Jalkunan
bxm	Mongolia Buriat	Buriat, Mongolia
bxn	Burduna	Burduna
bxo	Barikanchi	Barikanchi
bxp	Bebil	Bebil
bxq	Beele	Beele
bxr	Russia Buriat	Buriat, Russia
bxs	Busam	Busam
bxt	Buxinhua	Buxinhua
bxu	China Buriat	Buriat, China
bxv	Berakou	Berakou
bxw	Bankagooma	Bankagooma
bxx	Borna	Borna
bxz	Binahari	Binahari
bya	Batak	Batak
byb	Bikya	Bikya
byc	Ubaghara	Ubaghara
byd	Benyadu'	Benyadu'
bye	Pouye	Pouye
byf	Bete	Bete
byg	Baygo	Baygo
byh	Bujhyal	Bujhyal
byi	Buyu	Buyu
byj	Bina (Nigeria)	Bina (Nigeria)
byk	Biao	Biao
byl	Bayono	Bayono
bym	Bidyara	Bidyara
byn	Bilin	Bilin
byn	Blin	Blin
byo	Biyo	Biyo
byp	Bumaji	Bumaji
byq	Basay	Basay
byr	Baruya	Baruya
bys	Burak	Burak
byt	Berti	Berti
byu	Buyang	Buyang
byv	Medumba	Medumba
byw	Belhariya	Belhariya
byx	Qaqet	Qaqet
byy	Buya	Buya
byz	Banaro	Banaro
bza	Bandi	Bandi
bzb	Andio	Andio
bzd	Bribri	Bribri
bze	Jenaama Bozo	Bozo, Jenaama
bzf	Boikin	Boikin
bzg	Babuza	Babuza
bzh	Mapos Buang	Buang, Mapos
bzj	Belize Kriol English	Kriol English, Belize
bzk	Nicaragua Creole English	Creole English, Nicaragua
bzl	Boano (Sulawesi)	Boano (Sulawesi)
bzm	Bolondo	Bolondo
bzn	Boano (Maluku)	Boano (Maluku)
bzo	Bozaba	Bozaba
bzp	Kemberano	Kemberano
bzq	Buli (Indonesia)	Buli (Indonesia)
bzr	Biri	Biri
bzs	Brazilian Sign Language	Brazilian Sign Language
bzt	Brithenig	Brithenig
bzu	Burmeso	Burmeso
bzv	Bebe	Bebe
bzw	Basa (Nigeria)	Basa (Nigeria)
bzx	Hainyaxo Bozo	Bozo, Hainyaxo
bzy	Obanliku	Obanliku
bzz	Evant	Evant
caa	Chortí	Chortí
cab	Garifuna	Garifuna
cac	San Sebastián Coatán Chuj	Chuj, San Sebastián Coatán
cad	Caddo	Caddo
cae	Lehar	Lehar
caf	Southern Carrier	Carrier, Southern
cag	Nivaclé	Nivaclé
cah	Cahuarano	Cahuarano
caj	Chané	Chané
cak	Central Cakchiquel	Cakchiquel, Central
cal	Carolinian	Carolinian
cam	Cemuhî	Cemuhî
can	Chambri	Chambri
cao	Chácobo	Chácobo
cap	Chipaya	Chipaya
caq	Car Nicobarese	Nicobarese, Car
car	Galibi Carib	Carib, Galibi
cas	Tsimané	Tsimané
cat	Catalan	Catalan
cat	Valencian	Valencian
cav	Cavineña	Cavineña
caw	Callawalla	Callawalla
cax	Chiquitano	Chiquitano
cay	Cayuga	Cayuga
caz	Canichana	Canichana
cbb	Cabiyarí	Cabiyarí
cbc	Carapana	Carapana
cbd	Carijona	Carijona
cbe	Chipiajes	Chipiajes
cbg	Chimila	Chimila
cbh	Cagua	Cagua
cbi	Chachi	Chachi
cbj	Ede Cabe	Ede Cabe
cbk	Chavacano	Chavacano
cbl	Bualkhaw Chin	Chin, Bualkhaw
cbm	Yepocapa Southwestern Cakchiquel	Cakchiquel, Yepocapa Southwestern
cbn	Nyahkur	Nyahkur
cbo	Izora	Izora
cbr	Cashibo-Cacataibo	Cashibo-Cacataibo
cbs	Cashinahua	Cashinahua
cbt	Chayahuita	Chayahuita
cbu	Candoshi-Shapra	Candoshi-Shapra
cbv	Cacua	Cacua
cby	Carabayo	Carabayo
cca	Cauca	Cauca
ccc	Chamicuro	Chamicuro
ccd	Cafundo Creole	Creole, Cafundo
cce	Chopi	Chopi
ccg	Samba Daka	Daka, Samba
cch	Atsam	Atsam
ccj	Kasanga	Kasanga
ccl	Cutchi-Swahili	Cutchi-Swahili
ccm	Malaccan Creole Malay	Creole Malay, Malaccan
cco	Comaltepec Chinantec	Chinantec, Comaltepec
ccp	Chakma	Chakma
ccq	Chaungtha	Chaungtha
ccr	Cacaopera	Cacaopera
ccx	Northern Zhuang	Zhuang, Northern
cda	Choni	Choni
cde	Chenchu	Chenchu
cdf	Chiru	Chiru
cdg	Chamari	Chamari
cdh	Chambeali	Chambeali
cdi	Chodri	Chodri
cdj	Churahi	Churahi
cdm	Chepang	Chepang
cdn	Chaudangsi	Chaudangsi
cdo	Min Dong Chinese	Chinese, Min Dong
cdr	Cinda-Regi-Tiyal	Cinda-Regi-Tiyal
cds	Chadian Sign Language	Chadian Sign Language
cdz	Koda	Koda
cea	Lower Chehalis	Chehalis, Lower
ceb	Cebuano	Cebuano
ceg	Chamacoco	Chamacoco
cen	Cen	Cen
ces	Czech	Czech
cet	Centúúm	Centúúm
cfa	Dijim-Bwilim	Dijim-Bwilim
cfd	Cara	Cara
cfg	Como Karim	Como Karim
cfm	Falam Chin	Chin, Falam
cga	Changriwa	Changriwa
cgc	Kagayanen	Kagayanen
cgg	Chiga	Chiga
cgk	Chocangacakha	Chocangacakha
cha	Chamorro	Chamorro
chb	Chibcha	Chibcha
chc	Catawba	Catawba
chd	Highland Oaxaca Chontal	Chontal, Highland Oaxaca
che	Chechen	Chechen
chf	Tabasco Chontal	Chontal, Tabasco
chg	Chagatai	Chagatai
chh	Chinook	Chinook
chj	Ojitlán Chinantec	Chinantec, Ojitlán
chk	Chuukese	Chuukese
chl	Cahuilla	Cahuilla
chm	Mari (Russia)	Mari (Russia)
chn	Chinook jargon	Chinook jargon
cho	Choctaw	Choctaw
chp	Chipewyan	Chipewyan
chq	Quiotepec Chinantec	Chinantec, Quiotepec
chr	Cherokee	Cherokee
chs	Chumash	Chumash
cht	Cholón	Cholón
chu	Church Slavic	Slavic, Church
chu	Church Slavonic	Slavonic, Church
chu	Old Bulgarian	Bulgarian, Old
chu	Old Church Slavonic	Slavonic, Old Church
chu	Old Slavonic	Slavonic, Old
chv	Chuvash	Chuvash
chw	Chuwabu	Chuwabu
chx	Chantyal	Chantyal
chy	Cheyenne	Cheyenne
chz	Ozumacín Chinantec	Chinantec, Ozumacín
cia	Cia-Cia	Cia-Cia
cib	Ci Gbe	Gbe, Ci
cic	Chickasaw	Chickasaw
cid	Chimariko	Chimariko
cie	Cineni	Cineni
cih	Chinali	Chinali
cik	Chitkuli Kinnauri	Kinnauri, Chitkuli
cim	Cimbrian	Cimbrian
cin	Cinta Larga	Cinta Larga
cip	Chiapanec	Chiapanec
cir	Tiri	Tiri
ciw	Chippewa	Chippewa
ciy	Chaima	Chaima
cja	Western Cham	Cham, Western
cje	Chru	Chru
cjh	Upper Chehalis	Chehalis, Upper
cji	Chamalal	Chamalal
cjk	Chokwe	Chokwe
cjm	Eastern Cham	Cham, Eastern
cjn	Chenapian	Chenapian
cjo	Ashéninka Pajonal	Ashéninka Pajonal
cjp	Cabécar	Cabécar
cjr	Chorotega	Chorotega
cjs	Shor	Shor
cjv	Chuave	Chuave
cjy	Jinyu Chinese	Chinese, Jinyu
cka	Khumi Awa Chin	Chin, Khumi Awa
ckb	Central Kurdish	Kurdish, Central
ckc	Northern Cakchiquel	Cakchiquel, Northern
ckd	South Central Cakchiquel	Cakchiquel, South Central
cke	Eastern Cakchiquel	Cakchiquel, Eastern
ckf	Southern Cakchiquel	Cakchiquel, Southern
ckh	Chak	Chak
cki	Santa María De Jesús Cakchiquel	Cakchiquel, Santa María De Jesús
ckj	Santo Domingo Xenacoj Cakchiquel	Cakchiquel, Santo Domingo Xenacoj
ckk	Acatenango Southwestern Cakchiquel	Cakchiquel, Acatenango Southwestern
ckl	Cibak	Cibak
cko	Anufo	Anufo
ckq	Kajakse	Kajakse
ckr	Kairak	Kairak
cks	Tayo	Tayo
ckt	Chukot	Chukot
cku	Koasati	Koasati
ckv	Kavalan	Kavalan
ckw	Western Cakchiquel	Cakchiquel, Western
ckx	Caka	Caka
cky	Cakfem-Mushere	Cakfem-Mushere
ckz	Cakchiquel-Quiché Mixed Language	Cakchiquel-Quiché Mixed Language
cla	Ron	Ron
clc	Chilcotin	Chilcotin
cld	Chaldean Neo-Aramaic	Neo-Aramaic, Chaldean
cle	Lealao Chinantec	Chinantec, Lealao
clh	Chilisso	Chilisso
cli	Chakali	Chakali
clk	Idu-Mishmi	Idu-Mishmi
cll	Chala	Chala
clm	Clallam	Clallam
clo	Lowland Oaxaca Chontal	Chontal, Lowland Oaxaca
clu	Caluyanun	Caluyanun
clw	Chulym	Chulym
cly	Eastern Highland Chatino	Chatino, Eastern Highland
cma	Maa	Maa
cme	Cerma	Cerma
cmg	Classical Mongolian	Mongolian, Classical
cmi	Emberá-Chamí	Emberá-Chamí
cmk	Chimakum	Chimakum
cml	Campalagian	Campalagian
cmm	Michigamea	Michigamea
cmn	Mandarin Chinese	Chinese, Mandarin
cmo	Central Mnong	Mnong, Central
cmr	Mro Chin	Chin, Mro
cms	Messapic	Messapic
cmt	Camtho	Camtho
cna	Changthang	Changthang
cnb	Chinbon Chin	Chin, Chinbon
cnc	Côông	Côông
cng	Northern Qiang	Qiang, Northern
cnh	Haka Chin	Chin, Haka
cni	Asháninka	Asháninka
cnk	Khumi Chin	Chin, Khumi
cnl	Lalana Chinantec	Chinantec, Lalana
cnm	Ixtatán Chuj	Chuj, Ixtatán
cno	Con	Con
cns	Central Asmat	Asmat, Central
cnt	Tepetotutla Chinantec	Chinantec, Tepetotutla
cnu	Chenoua	Chenoua
cnw	Ngawn Chin	Chin, Ngawn
cnx	Middle Cornish	Cornish, Middle
coa	Cocos Islands Malay	Malay, Cocos Islands
cob	Chicomuceltec	Chicomuceltec
coc	Cocopa	Cocopa
cod	Cocama-Cocamilla	Cocama-Cocamilla
coe	Koreguaje	Koreguaje
cof	Colorado	Colorado
cog	Chong	Chong
coh	Chonyi	Chonyi
coj	Cochimi	Cochimi
cok	Santa Teresa Cora	Cora, Santa Teresa
col	Columbia-Wenatchi	Columbia-Wenatchi
com	Comanche	Comanche
con	Cofán	Cofán
coo	Comox	Comox
cop	Coptic	Coptic
coq	Coquille	Coquille
cor	Cornish	Cornish
cos	Corsican	Corsican
cot	Caquinte	Caquinte
cou	Wamey	Wamey
cov	Cao Miao	Cao Miao
cow	Cowlitz	Cowlitz
cox	Nanti	Nanti
coy	Coyaima	Coyaima
coz	Chochotec	Chochotec
cpa	Palantla Chinantec	Chinantec, Palantla
cpb	Ucayali-Yurúa Ashéninka	Ashéninka, Ucayali-Yurúa
cpc	Ajyíninka Apurucayali	Ajyíninka Apurucayali
cpg	Cappadocian Greek	Greek, Cappadocian
cpi	Chinese Pidgin English	Pidgin English, Chinese
cpn	Cherepon	Cherepon
cps	Capiznon	Capiznon
cpu	Pichis Ashéninka	Ashéninka, Pichis
cpx	Pu-Xian Chinese	Chinese, Pu-Xian
cpy	South Ucayali Ashéninka	Ashéninka, South Ucayali
cqu	Chilean Quechua	Quechua, Chilean
cra	Chara	Chara
crb	Island Carib	Carib, Island
crc	Lonwolwol	Lonwolwol
crd	Coeur d'Alene	Coeur d'Alene
cre	Cree	Cree
crf	Caramanta	Caramanta
crg	Michif	Michif
crh	Crimean Tatar	Tatar, Crimean
crh	Crimean Turkish	Turkish, Crimean
cri	Sãotomense	Sãotomense
crj	Southern East Cree	Cree, Southern East
crk	Plains Cree	Cree, Plains
crl	Northern East Cree	Cree, Northern East
crm	Moose Cree	Cree, Moose
crn	El Nayar Cora	Cora, El Nayar
cro	Crow	Crow
crq	Iyo'wujwa Chorote	Chorote, Iyo'wujwa
crr	Carolina Algonquian	Algonquian, Carolina
crs	Seselwa Creole French	Creole French, Seselwa
crt	Iyojwa'ja Chorote	Chorote, Iyojwa'ja
cru	Carútana	Carútana
crv	Chaura	Chaura
crw	Chrau	Chrau
crx	Carrier	Carrier
cry	Cori	Cori
crz	Cruzeño	Cruzeño
csa	Chiltepec Chinantec	Chinantec, Chiltepec
csb	Kashubian	Kashubian
csc	Catalan Sign Language	Catalan Sign Language
csc	Lengua de señas catalana	Lengua de señas catalana
csc	Llengua de Signes Catalana	Llengua de Signes Catalana
csd	Chiangmai Sign Language	Chiangmai Sign Language
cse	Czech Sign Language	Czech Sign Language
csf	Cuba Sign Language	Cuba Sign Language
csg	Chilean Sign Language	Chilean Sign Language
csh	Asho Chin	Chin, Asho
csi	Coast Miwok	Miwok, Coast
csk	Jola-Kasa	Jola-Kasa
csl	Chinese Sign Language	Chinese Sign Language
csm	Central Sierra Miwok	Miwok, Central Sierra
csn	Colombian Sign Language	Colombian Sign Language
cso	Sochiapam Chinantec	Chinantec, Sochiapam
cso	Sochiapan Chinantec	Chinantec, Sochiapan
csq	Croatia Sign Language	Croatia Sign Language
csr	Costa Rican Sign Language	Costa Rican Sign Language
css	Southern Ohlone	Ohlone, Southern
cst	Northern Ohlone	Ohlone, Northern
csw	Swampy Cree	Cree, Swampy
csy	Siyin Chin	Chin, Siyin
csz	Coos	Coos
cta	Tataltepec Chatino	Chatino, Tataltepec
ctc	Chetco	Chetco
ctd	Tedim Chin	Chin, Tedim
cte	Tepinapa Chinantec	Chinantec, Tepinapa
ctg	Chittagonian	Chittagonian
cti	Tila Chol	Chol, Tila
ctl	Tlacoatzintepec Chinantec	Chinantec, Tlacoatzintepec
ctm	Chitimacha	Chitimacha
ctn	Chhintange	Chhintange
cto	Emberá-Catío	Emberá-Catío
ctp	Western Highland Chatino	Chatino, Western Highland
cts	Northern Catanduanes Bicolano	Bicolano, Northern Catanduanes
ctt	Wayanad Chetti	Chetti, Wayanad
ctu	Tumbalá Chol	Chol, Tumbalá
ctz	Zacatepec Chatino	Chatino, Zacatepec
cua	Cua	Cua
cub	Cubeo	Cubeo
cuc	Usila Chinantec	Chinantec, Usila
cug	Cung	Cung
cuh	Chuka	Chuka
cui	Cuiba	Cuiba
cuj	Mashco Piro	Mashco Piro
cuk	San Blas Kuna	Kuna, San Blas
cul	Culina	Culina
cum	Cumeral	Cumeral
cun	Cunén Quiché	Quiché, Cunén
cuo	Cumanagoto	Cumanagoto
cup	Cupeño	Cupeño
cuq	Cun	Cun
cur	Chhulung	Chhulung
cut	Teutila Cuicatec	Cuicatec, Teutila
cuu	Tai Ya	Tai Ya
cuv	Cuvok	Cuvok
cuw	Chukwa	Chukwa
cux	Tepeuxila Cuicatec	Cuicatec, Tepeuxila
cvg	Chug	Chug
cvn	Valle Nacional Chinantec	Chinantec, Valle Nacional
cwa	Kabwa	Kabwa
cwb	Maindo	Maindo
cwd	Woods Cree	Cree, Woods
cwe	Kwere	Kwere
cwg	Chewong	Chewong
cwt	Kuwaataay	Kuwaataay
cya	Nopala Chatino	Chatino, Nopala
cyb	Cayubaba	Cayubaba
cym	Welsh	Welsh
cyo	Cuyonon	Cuyonon
czh	Huizhou Chinese	Chinese, Huizhou
czk	Knaanic	Knaanic
czn	Zenzontepec Chatino	Chatino, Zenzontepec
czo	Min Zhong Chinese	Chinese, Min Zhong
czt	Zotung Chin	Chin, Zotung
daa	Dangaléat	Dangaléat
dac	Dambi	Dambi
dad	Marik	Marik
dae	Duupa	Duupa
daf	Dan	Dan
dag	Dagbani	Dagbani
dah	Gwahatike	Gwahatike
dai	Day	Day
daj	Dar Fur Daju	Daju, Dar Fur
dak	Dakota	Dakota
dal	Dahalo	Dahalo
dan	Danish	Danish
dao	Daai Chin	Chin, Daai
dap	Nisi	Nisi
daq	Dandami Maria	Maria, Dandami
dar	Dargwa	Dargwa
das	Daho-Doo	Daho-Doo
dat	Darang Deng	Deng, Darang
dau	Dar Sila Daju	Daju, Dar Sila
dav	Taita	Taita
daw	Davawenyo	Davawenyo
dax	Dayi	Dayi
daz	Dao	Dao
dba	Bangi Me	Bangi Me
dbb	Deno	Deno
dbd	Dadiya	Dadiya
dbe	Dabe	Dabe
dbf	Edopi	Edopi
dbg	Dogul Dom Dogon	Dogon, Dogul Dom
dbi	Doka	Doka
dbj	Ida'an	Ida'an
dbl	Dyirbal	Dyirbal
dbm	Duguri	Duguri
dbn	Duriankere	Duriankere
dbo	Dulbu	Dulbu
dbp	Duwai	Duwai
dbq	Daba	Daba
dbr	Dabarre	Dabarre
dbu	Bondum Dom Dogon	Dogon, Bondum Dom
dbv	Dungu	Dungu
dby	Dibiyaso	Dibiyaso
dcc	Deccan	Deccan
dcr	Negerhollands	Negerhollands
ddd	Dongotono	Dongotono
dde	Doondo	Doondo
ddg	Fataluku	Fataluku
ddi	Diodio	Diodio
ddj	Jaru	Jaru
ddn	Dendi (Benin)	Dendi (Benin)
ddo	Dido	Dido
dds	Donno So Dogon	Dogon, Donno So
ddw	Dawera-Daweloor	Dawera-Daweloor
dec	Dagik	Dagik
ded	Dedua	Dedua
dee	Dewoin	Dewoin
def	Dezfuli	Dezfuli
deg	Degema	Degema
deh	Dehwari	Dehwari
dei	Demisa	Demisa
dek	Dek	Dek
del	Delaware	Delaware
dem	Dem	Dem
den	Slave (Athapascan)	Slave (Athapascan)
dep	Pidgin Delaware	Delaware, Pidgin
deq	Dendi (Central African Republic)	Dendi (Central African Republic)
der	Deori	Deori
des	Desano	Desano
deu	German	German
dev	Domung	Domung
dez	Dengese	Dengese
dga	Southern Dagaare	Dagaare, Southern
dgb	Bunoge Dogon	Dogon, Bunoge
dgc	Casiguran Dumagat Agta	Agta, Casiguran Dumagat
dgd	Dagaari Dioula	Dagaari Dioula
dge	Degenan	Degenan
dgg	Doga	Doga
dgh	Dghwede	Dghwede
dgi	Northern Dagara	Dagara, Northern
dgk	Dagba	Dagba
dgn	Dagoman	Dagoman
dgo	Dogri (individual language)	Dogri (individual language)
dgr	Dogrib	Dogrib
dgs	Dogoso	Dogoso
dgu	Degaru	Degaru
dgx	Doghoro	Doghoro
dgz	Daga	Daga
dha	Dhanwar (India)	Dhanwar (India)
dhd	Dhundari	Dhundari
dhg	Dhangu	Dhangu
dhi	Dhimal	Dhimal
dhl	Dhalandji	Dhalandji
dhm	Zemba	Zemba
dhn	Dhanki	Dhanki
dho	Dhodia	Dhodia
dhr	Dhargari	Dhargari
dhs	Dhaiso	Dhaiso
dhu	Dhurga	Dhurga
dhv	Dehu	Dehu
dhw	Dhanwar (Nepal)	Dhanwar (Nepal)
dia	Dia	Dia
dib	South Central Dinka	Dinka, South Central
dic	Lakota Dida	Dida, Lakota
did	Didinga	Didinga
dif	Dieri	Dieri
dig	Digo	Digo
dih	Kumiai	Kumiai
dii	Dimbong	Dimbong
dij	Dai	Dai
dik	Southwestern Dinka	Dinka, Southwestern
dil	Dilling	Dilling
dim	Dime	Dime
din	Dinka	Dinka
dio	Dibo	Dibo
dip	Northeastern Dinka	Dinka, Northeastern
diq	Dimli	Dimli
dir	Dirim	Dirim
dis	Dimasa	Dimasa
dit	Dirari	Dirari
diu	Diriku	Diriku
div	Dhivehi	Dhivehi
div	Divehi	Divehi
div	Maldivian	Maldivian
diw	Northwestern Dinka	Dinka, Northwestern
dix	Dixon Reef	Dixon Reef
diy	Diuwe	Diuwe
diz	Ding	Ding
djb	Djinba	Djinba
djc	Dar Daju Daju	Daju, Dar Daju
djd	Djamindjung	Djamindjung
dje	Zarma	Zarma
djf	Djangun	Djangun
dji	Djinang	Djinang
djj	Djeebbana	Djeebbana
djk	Aukan	Aukan
djl	Djiwarli	Djiwarli
djm	Jamsay Dogon	Dogon, Jamsay
djn	Djauan	Djauan
djo	Djongkang	Djongkang
djr	Djambarrpuyngu	Djambarrpuyngu
dju	Kapriman	Kapriman
djw	Djawi	Djawi
dka	Dakpakha	Dakpakha
dkk	Dakka	Dakka
dkl	Kolum So Dogon	Dogon, Kolum So
dkr	Kuijau	Kuijau
dks	Southeastern Dinka	Dinka, Southeastern
dkx	Mazagway	Mazagway
dlg	Dolgan	Dolgan
dlm	Dalmatian	Dalmatian
dln	Darlong	Darlong
dma	Duma	Duma
dmc	Dimir	Dimir
dme	Dugwor	Dugwor
dmg	Upper Kinabatangan	Kinabatangan, Upper
dmk	Domaaki	Domaaki
dml	Dameli	Dameli
dmm	Dama	Dama
dmo	Kemezung	Kemezung
dmr	East Damar	Damar, East
dms	Dampelas	Dampelas
dmu	Dubu	Dubu
dmv	Dumpas	Dumpas
dmx	Dema	Dema
dmy	Demta	Demta
dna	Upper Grand Valley Dani	Dani, Upper Grand Valley
dnd	Daonda	Daonda
dne	Ndendeule	Ndendeule
dng	Dungan	Dungan
dni	Lower Grand Valley Dani	Dani, Lower Grand Valley
dnk	Dengka	Dengka
dnn	Dzùùngoo	Dzùùngoo
dnr	Danaru	Danaru
dnt	Mid Grand Valley Dani	Dani, Mid Grand Valley
dnu	Danau	Danau
dnw	Western Dani	Dani, Western
dny	Dení	Dení
doa	Dom	Dom
dob	Dobu	Dobu
doc	Northern Dong	Dong, Northern
doe	Doe	Doe
dof	Domu	Domu
doh	Dong	Dong
doi	Dogri (macrolanguage)	Dogri (macrolanguage)
dok	Dondo	Dondo
dol	Doso	Doso
don	Toura (Papua New Guinea)	Toura (Papua New Guinea)
doo	Dongo	Dongo
dop	Lukpa	Lukpa
doq	Dominican Sign Language	Dominican Sign Language
dor	Dori'o	Dori'o
dos	Dogosé	Dogosé
dot	Dass	Dass
dov	Dombe	Dombe
dow	Doyayo	Doyayo
dox	Bussa	Bussa
doy	Dompo	Dompo
doz	Dorze	Dorze
dpp	Papar	Papar
drb	Dair	Dair
drd	Darmiya	Darmiya
dre	Dolpo	Dolpo
drg	Rungus	Rungus
drh	Darkhat	Darkhat
dri	C'lela	C'lela
drl	Darling	Darling
drn	West Damar	Damar, West
dro	Daro-Matu	Daro-Matu
drq	Dura	Dura
drr	Dororo	Dororo
drs	Gedeo	Gedeo
drt	Drents	Drents
dru	Rukai	Rukai
drw	Darwazi	Darwazi
dry	Darai	Darai
dsb	Lower Sorbian	Sorbian, Lower
dse	Dutch Sign Language	Dutch Sign Language
dsh	Daasanach	Daasanach
dsi	Disa	Disa
dsl	Danish Sign Language	Danish Sign Language
dsn	Dusner	Dusner
dso	Desiya	Desiya
dsq	Tadaksahak	Tadaksahak
dta	Daur	Daur
dtb	Labuk-Kinabatangan Kadazan	Kadazan, Labuk-Kinabatangan
dti	Ana Tinga Dogon	Dogon, Ana Tinga
dtk	Tene Kan Dogon	Dogon, Tene Kan
dtm	Tomo Kan Dogon	Dogon, Tomo Kan
dtp	Central Dusun	Dusun, Central
dtr	Lotud	Lotud
dts	Toro So Dogon	Dogon, Toro So
dtt	Toro Tegu Dogon	Dogon, Toro Tegu
dtu	Tebul Ure Dogon	Dogon, Tebul Ure
dua	Duala	Duala
dub	Dubli	Dubli
duc	Duna	Duna
dud	Hun-Saare	Hun-Saare
due	Umiray Dumaget Agta	Agta, Umiray Dumaget
duf	Dumbea	Dumbea
dug	Duruma	Duruma
duh	Dungra Bhil	Dungra Bhil
dui	Dumun	Dumun
duj	Dhuwal	Dhuwal
duk	Duduela	Duduela
dul	Alabat Island Agta	Agta, Alabat Island
dum	Middle Dutch (ca. 1050-1350)	Dutch, Middle (ca. 1050-1350)
dun	Dusun Deyah	Dusun Deyah
duo	Dupaninan Agta	Agta, Dupaninan
dup	Duano	Duano
duq	Dusun Malang	Dusun Malang
dur	Dii	Dii
dus	Dumi	Dumi
duu	Drung	Drung
duv	Duvle	Duvle
duw	Dusun Witu	Dusun Witu
dux	Duungooma	Duungooma
duy	Dicamay Agta	Agta, Dicamay
duz	Duli	Duli
dva	Duau	Duau
dwa	Diri	Diri
dwl	Walo Kumbe Dogon	Dogon, Walo Kumbe
dws	Dutton World Speedwords	Dutton World Speedwords
dww	Dawawa	Dawawa
dya	Dyan	Dyan
dyb	Dyaberdyaber	Dyaberdyaber
dyd	Dyugun	Dyugun
dyg	Villa Viciosa Agta	Agta, Villa Viciosa
dyi	Djimini Senoufo	Senoufo, Djimini
dyk	Land Dayak	Dayak, Land
dym	Yanda Dom Dogon	Dogon, Yanda Dom
dyn	Dyangadi	Dyangadi
dyo	Jola-Fonyi	Jola-Fonyi
dyu	Dyula	Dyula
dyy	Dyaabugay	Dyaabugay
dza	Tunzu	Tunzu
dzd	Daza	Daza
dzg	Dazaga	Dazaga
dzl	Dzalakha	Dzalakha
dzn	Dzando	Dzando
dzo	Dzongkha	Dzongkha
ebg	Ebughu	Ebughu
ebo	Teke-Ebo	Teke-Ebo
ebr	Ebrié	Ebrié
ebu	Embu	Embu
ecr	Eteocretan	Eteocretan
ecs	Ecuadorian Sign Language	Ecuadorian Sign Language
ecy	Eteocypriot	Eteocypriot
eee	E	E
efa	Efai	Efai
efe	Efe	Efe
efi	Efik	Efik
ega	Ega	Ega
ego	Eggon	Eggon
egy	Egyptian (Ancient)	Egyptian (Ancient)
ehu	Ehueun	Ehueun
eip	Eipomek	Eipomek
eit	Eitiep	Eitiep
eiv	Askopan	Askopan
eja	Ejamat	Ejamat
eka	Ekajuk	Ekajuk
eke	Ekit	Ekit
ekg	Ekari	Ekari
eki	Eki	Eki
ekm	Elip	Elip
eko	Koti	Koti
ekp	Ekpeye	Ekpeye
ekr	Yace	Yace
eky	Eastern Kayah	Kayah, Eastern
ele	Elepi	Elepi
elh	El Hugeirat	El Hugeirat
eli	Nding	Nding
elk	Elkei	Elkei
ell	Modern Greek (1453-)	Greek, Modern (1453-)
elm	Eleme	Eleme
elo	El Molo	El Molo
elp	Elpaputih	Elpaputih
elu	Elu	Elu
elx	Elamite	Elamite
ema	Emai-Iuleha-Ora	Emai-Iuleha-Ora
emb	Embaloh	Embaloh
eme	Emerillon	Emerillon
emg	Eastern Meohang	Meohang, Eastern
emi	Mussau-Emira	Mussau-Emira
emk	Eastern Maninkakan	Maninkakan, Eastern
eml	Emiliano-Romagnolo	Emiliano-Romagnolo
emm	Mamulique	Mamulique
emn	Eman	Eman
emo	Emok	Emok
emp	Northern Emberá	Emberá, Northern
ems	Pacific Gulf Yupik	Yupik, Pacific Gulf
emu	Eastern Muria	Muria, Eastern
emw	Emplawas	Emplawas
emy	Epigraphic Mayan	Mayan, Epigraphic
ena	Apali	Apali
enb	Northern Marakwet	Marakwet, Northern
enc	En	En
end	Ende	Ende
enf	Forest Enets	Enets, Forest
eng	English	English
enh	Tundra Enets	Enets, Tundra
eni	Enim	Enim
enm	Middle English (1100-1500)	English, Middle (1100-1500)
enn	Engenni	Engenni
eno	Enggano	Enggano
enq	Enga	Enga
enr	Emumu	Emumu
enu	Enu	Enu
env	Enwan (Edu State)	Enwan (Edu State)
enw	Enwan (Akwa Ibom State)	Enwan (Akwa Ibom State)
eot	Beti (Côte d'Ivoire)	Beti (Côte d'Ivoire)
epi	Epie	Epie
epo	Esperanto	Esperanto
era	Eravallan	Eravallan
erg	Sie	Sie
erh	Eruwa	Eruwa
eri	Ogea	Ogea
erk	South Efate	Efate, South
ero	Horpa	Horpa
err	Erre	Erre
ers	Ersu	Ersu
ert	Eritai	Eritai
erw	Erokwanas	Erokwanas
ese	Ese Ejja	Ese Ejja
esh	Eshtehardi	Eshtehardi
esi	North Alaskan Inupiatun	Inupiatun, North Alaskan
esk	Northwest Alaska Inupiatun	Inupiatun, Northwest Alaska
esl	Egypt Sign Language	Egypt Sign Language
esm	Esuma	Esuma
esn	Salvadoran Sign Language	Salvadoran Sign Language
eso	Estonian Sign Language	Estonian Sign Language
esq	Esselen	Esselen
ess	Central Siberian Yupik	Yupik, Central Siberian
est	Estonian	Estonian
esu	Central Yupik	Yupik, Central
etb	Etebi	Etebi
etc	Etchemin	Etchemin
eth	Ethiopian Sign Language	Ethiopian Sign Language
etn	Eton (Vanuatu)	Eton (Vanuatu)
eto	Eton (Cameroon)	Eton (Cameroon)
etr	Edolo	Edolo
ets	Yekhee	Yekhee
ett	Etruscan	Etruscan
etu	Ejagham	Ejagham
etx	Eten	Eten
etz	Semimi	Semimi
eur	Europanto	Europanto
eus	Basque	Basque
eve	Even	Even
evh	Uvbie	Uvbie
evn	Evenki	Evenki
ewe	Ewe	Ewe
ewo	Ewondo	Ewondo
ext	Extremaduran	Extremaduran
eya	Eyak	Eyak
eze	Uzekwe	Uzekwe
faa	Fasu	Fasu
fab	Fa D'ambu	Fa D'ambu
fad	Wagi	Wagi
faf	Fagani	Fagani
fag	Finongan	Finongan
fah	Baissa Fali	Fali, Baissa
fai	Faiwol	Faiwol
faj	Faita	Faita
fak	Fang (Cameroon)	Fang (Cameroon)
fal	South Fali	Fali, South
fam	Fam	Fam
fan	Fang (Equatorial Guinea)	Fang (Equatorial Guinea)
fao	Faroese	Faroese
fap	Palor	Palor
far	Fataleka	Fataleka
fas	Persian	Persian
fat	Fanti	Fanti
fau	Fayu	Fayu
fax	Fala	Fala
fay	Southwestern Fars	Fars, Southwestern
faz	Northwestern Fars	Fars, Northwestern
fcs	Quebec Sign Language	Quebec Sign Language
fer	Feroge	Feroge
ffi	Foia Foia	Foia Foia
ffm	Maasina Fulfulde	Fulfulde, Maasina
fgr	Fongoro	Fongoro
fia	Nobiin	Nobiin
fie	Fyer	Fyer
fij	Fijian	Fijian
fil	Filipino	Filipino
fil	Pilipino	Pilipino
fin	Finnish	Finnish
fip	Fipa	Fipa
fir	Firan	Firan
fit	Tornedalen Finnish	Finnish, Tornedalen
fiw	Fiwaga	Fiwaga
fiz	Izere	Izere
fkv	Kven Finnish	Finnish, Kven
fla	Kalispel-Pend d'Oreille	Kalispel-Pend d'Oreille
flh	Foau	Foau
fli	Fali	Fali
fll	North Fali	Fali, North
fln	Flinders Island	Flinders Island
flr	Fuliiru	Fuliiru
fly	Tsotsitaal	Tsotsitaal
fmp	Fe'fe'	Fe'fe'
fmu	Far Western Muria	Muria, Far Western
fng	Fanagalo	Fanagalo
fni	Fania	Fania
fod	Foodo	Foodo
foi	Foi	Foi
fom	Foma	Foma
fon	Fon	Fon
for	Fore	Fore
fos	Siraya	Siraya
fpe	Fernando Po Creole English	Creole English, Fernando Po
fqs	Fas	Fas
fra	French	French
frc	Cajun French	French, Cajun
frd	Fordata	Fordata
frk	Frankish	Frankish
frm	Middle French (ca. 1400-1600)	French, Middle (ca. 1400-1600)
fro	Old French (842-ca. 1400)	French, Old (842-ca. 1400)
frp	Franco-Provençal	Franco-Provençal
frq	Forak	Forak
frr	Northern Frisian	Frisian, Northern
frs	Eastern Frisian	Frisian, Eastern
frt	Fortsenal	Fortsenal
fry	Western Frisian	Frisian, Western
fse	Finnish Sign Language	Finnish Sign Language
fsl	French Sign Language	French Sign Language
fss	Finnish-Swedish Sign Language	Finnish-Swedish Sign Language
fub	Adamawa Fulfulde	Fulfulde, Adamawa
fuc	Pulaar	Pulaar
fud	East Futuna	Futuna, East
fue	Borgu Fulfulde	Fulfulde, Borgu
fuf	Pular	Pular
fuh	Western Niger Fulfulde	Fulfulde, Western Niger
fui	Bagirmi Fulfulde	Fulfulde, Bagirmi
fuj	Ko	Ko
ful	Fulah	Fulah
fum	Fum	Fum
fun	Fulniô	Fulniô
fuq	Central-Eastern Niger Fulfulde	Fulfulde, Central-Eastern Niger
fur	Friulian	Friulian
fut	Futuna-Aniwa	Futuna-Aniwa
fuu	Furu	Furu
fuv	Nigerian Fulfulde	Fulfulde, Nigerian
fuy	Fuyug	Fuyug
fvr	Fur	Fur
fwa	Fwâi	Fwâi
fwe	Fwe	Fwe
gaa	Ga	Ga
gab	Gabri	Gabri
gad	Gaddang	Gaddang
gae	Guarequena	Guarequena
gaf	Gende	Gende
gag	Gagauz	Gagauz
gah	Alekano	Alekano
gai	Borei	Borei
gaj	Gadsup	Gadsup
gak	Gamkonora	Gamkonora
gal	Galoli	Galoli
gam	Kandawo	Kandawo
gan	Gan Chinese	Chinese, Gan
gao	Gants	Gants
gap	Gal	Gal
gaq	Gata'	Gata'
gar	Galeya	Galeya
gas	Adiwasi Garasia	Garasia, Adiwasi
gat	Kenati	Kenati
gau	Mudhili Gadaba	Gadaba, Mudhili
gav	Gabutamon	Gabutamon
gaw	Nobonob	Nobonob
gax	Borana-Arsi-Guji Oromo	Oromo, Borana-Arsi-Guji
gay	Gayo	Gayo
gaz	West Central Oromo	Oromo, West Central
gba	Gbaya (Central African Republic)	Gbaya (Central African Republic)
gbb	Kaytetye	Kaytetye
gbc	Garawa	Garawa
gbd	Karadjeri	Karadjeri
gbe	Niksek	Niksek
gbf	Gaikundi	Gaikundi
gbg	Gbanziri	Gbanziri
gbh	Defi Gbe	Gbe, Defi
gbi	Galela	Galela
gbj	Bodo Gadaba	Gadaba, Bodo
gbk	Gaddi	Gaddi
gbl	Gamit	Gamit
gbm	Garhwali	Garhwali
gbn	Mo'da	Mo'da
gbo	Northern Grebo	Grebo, Northern
gbp	Gbaya-Bossangoa	Gbaya-Bossangoa
gbq	Gbaya-Bozoum	Gbaya-Bozoum
gbr	Gbagyi	Gbagyi
gbs	Gbesi Gbe	Gbe, Gbesi
gbu	Gagadu	Gagadu
gbv	Gbanu	Gbanu
gbx	Eastern Xwla Gbe	Gbe, Eastern Xwla
gby	Gbari	Gbari
gbz	Zoroastrian Dari	Dari, Zoroastrian
gcc	Mali	Mali
gcd	Ganggalida	Ganggalida
gce	Galice	Galice
gcf	Guadeloupean Creole French	Creole French, Guadeloupean
gcl	Grenadian Creole English	Creole English, Grenadian
gcn	Gaina	Gaina
gcr	Guianese Creole French	Creole French, Guianese
gct	Colonia Tovar German	German, Colonia Tovar
gda	Gade Lohar	Lohar, Gade
gdb	Pottangi Ollar Gadaba	Gadaba, Pottangi Ollar
gdc	Gugu Badhun	Gugu Badhun
gdd	Gedaged	Gedaged
gde	Gude	Gude
gdf	Guduf-Gava	Guduf-Gava
gdg	Ga'dang	Ga'dang
gdh	Gadjerawang	Gadjerawang
gdi	Gundi	Gundi
gdj	Gurdjar	Gurdjar
gdk	Gadang	Gadang
gdl	Dirasha	Dirasha
gdm	Laal	Laal
gdn	Umanakaina	Umanakaina
gdo	Ghodoberi	Ghodoberi
gdq	Mehri	Mehri
gdr	Wipi	Wipi
gdu	Gudu	Gudu
gdx	Godwari	Godwari
gea	Geruma	Geruma
geb	Kire	Kire
gec	Gboloo Grebo	Grebo, Gboloo
ged	Gade	Gade
geg	Gengle	Gengle
geh	Hutterite German	German, Hutterite
gei	Gebe	Gebe
gej	Gen	Gen
gek	Yiwom	Yiwom
gel	Kag-Fer-Jiir-Koor-Ror-Us-Zuksun	Kag-Fer-Jiir-Koor-Ror-Us-Zuksun
gen	Geman Deng	Geman Deng
geq	Geme	Geme
ges	Geser-Gorom	Geser-Gorom
gew	Gera	Gera
gex	Garre	Garre
gey	Enya	Enya
gez	Geez	Geez
gfk	Patpatar	Patpatar
gft	Gafat	Gafat
gga	Gao	Gao
ggb	Gbii	Gbii
ggd	Gugadj	Gugadj
gge	Guragone	Guragone
ggg	Gurgula	Gurgula
ggh	Garreh-Ajuran	Garreh-Ajuran
ggk	Kungarakany	Kungarakany
ggl	Ganglau	Ganglau
ggn	Eastern Gurung	Gurung, Eastern
ggo	Southern Gondi	Gondi, Southern
ggr	Aghu Tharnggalu	Aghu Tharnggalu
ggt	Gitua	Gitua
ggu	Gagu	Gagu
ggw	Gogodala	Gogodala
gha	Ghadamès	Ghadamès
ghc	Hiberno-Scottish Gaelic	Gaelic, Hiberno-Scottish
ghe	Southern Ghale	Ghale, Southern
ghh	Northern Ghale	Ghale, Northern
ghk	Geko Karen	Karen, Geko
ghl	Ghulfan	Ghulfan
ghn	Ghanongga	Ghanongga
gho	Ghomara	Ghomara
ghr	Ghera	Ghera
ghs	Guhu-Samane	Guhu-Samane
ght	Kutang Ghale	Ghale, Kutang
gia	Kitja	Kitja
gib	Gibanawa	Gibanawa
gic	Gail	Gail
gid	Gidar	Gidar
gig	Goaria	Goaria
gil	Gilbertese	Gilbertese
gim	Gimi (Eastern Highlands)	Gimi (Eastern Highlands)
gin	Hinukh	Hinukh
gio	Gelao	Gelao
gip	Gimi (West New Britain)	Gimi (West New Britain)
giq	Green Gelao	Gelao, Green
gir	Red Gelao	Gelao, Red
gis	North Giziga	Giziga, North
git	Gitxsan	Gitxsan
giw	White Gelao	Gelao, White
gix	Gilima	Gilima
giy	Giyug	Giyug
giz	South Giziga	Giziga, South
gji	Geji	Geji
gjk	Kachi Koli	Koli, Kachi
gjn	Gonja	Gonja
gju	Gujari	Gujari
gka	Guya	Guya
gke	Ndai	Ndai
gkn	Gokana	Gokana
gkp	Guinea Kpelle	Kpelle, Guinea
gla	Gaelic	Gaelic
gla	Scottish Gaelic	Gaelic, Scottish
glc	Bon Gula	Bon Gula
gld	Nanai	Nanai
gle	Irish	Irish
glg	Galician	Galician
glh	Northwest Pashayi	Pashayi, Northwest
gli	Guliguli	Guliguli
glj	Gula Iro	Gula Iro
glk	Gilaki	Gilaki
glo	Galambu	Galambu
glr	Glaro-Twabo	Glaro-Twabo
glu	Gula (Chad)	Gula (Chad)
glv	Manx	Manx
glw	Glavda	Glavda
gly	Gule	Gule
gma	Gambera	Gambera
gmb	Gula'alaa	Gula'alaa
gmd	Mághdì	Mághdì
gmh	Middle High German (ca. 1050-1500)	German, Middle High (ca. 1050-1500)
gml	Middle Low German	German, Middle Low
gmn	Gimnime	Gimnime
gmo	Gamo-Gofa-Dawro	Gamo-Gofa-Dawro
gmu	Gumalu	Gumalu
gmx	Magoma	Magoma
gmy	Mycenaean Greek	Greek, Mycenaean
gna	Kaansa	Kaansa
gnb	Gangte	Gangte
gnc	Guanche	Guanche
gnd	Zulgo-Gemzek	Zulgo-Gemzek
gng	Ngangam	Ngangam
gnh	Lere	Lere
gni	Gooniyandi	Gooniyandi
gnk	//Gana	//Gana
gnl	Gangulu	Gangulu
gnm	Ginuman	Ginuman
gnn	Gumatj	Gumatj
gno	Northern Gondi	Gondi, Northern
gnq	Gana	Gana
gnr	Gureng Gureng	Gureng Gureng
gnt	Guntai	Guntai
gnu	Gnau	Gnau
gnw	Western Bolivian Guaraní	Guaraní, Western Bolivian
gnz	Ganzi	Ganzi
goa	Guro	Guro
gob	Playero	Playero
goc	Gorakor	Gorakor
god	Godié	Godié
goe	Gongduk	Gongduk
gog	Gogo	Gogo
goh	Old High German (ca. 750-1050)	German, Old High (ca. 750-1050)
goi	Gobasi	Gobasi
goj	Gowlan	Gowlan
gok	Gowli	Gowli
gol	Gola	Gola
gom	Goan Konkani	Konkani, Goan
gon	Gondi	Gondi
goo	Gone Dau	Gone Dau
gop	Yeretuar	Yeretuar
goq	Gorap	Gorap
gor	Gorontalo	Gorontalo
gos	Gronings	Gronings
got	Gothic	Gothic
gou	Gavar	Gavar
gow	Gorowa	Gorowa
gox	Gobu	Gobu
goy	Goundo	Goundo
goz	Gozarkhani	Gozarkhani
gpa	Gupa-Abawa	Gupa-Abawa
gpn	Taiap	Taiap
gqa	Ga'anda	Ga'anda
gqi	Guiqiong	Guiqiong
gqn	Guana (Brazil)	Guana (Brazil)
gqr	Gor	Gor
gra	Rajput Garasia	Garasia, Rajput
grb	Grebo	Grebo
grc	Ancient Greek (to 1453)	Greek, Ancient (to 1453)
grd	Guruntum-Mbaaru	Guruntum-Mbaaru
grg	Madi	Madi
grh	Gbiri-Niragu	Gbiri-Niragu
gri	Ghari	Ghari
grj	Southern Grebo	Grebo, Southern
grm	Kota Marudu Talantang	Kota Marudu Talantang
grn	Guarani	Guarani
gro	Groma	Groma
grq	Gorovu	Gorovu
grr	Taznatit	Taznatit
grs	Gresi	Gresi
grt	Garo	Garo
gru	Kistane	Kistane
grv	Central Grebo	Grebo, Central
grw	Gweda	Gweda
grx	Guriaso	Guriaso
gry	Barclayville Grebo	Grebo, Barclayville
grz	Guramalum	Guramalum
gse	Ghanaian Sign Language	Ghanaian Sign Language
gsg	German Sign Language	German Sign Language
gsl	Gusilay	Gusilay
gsm	Guatemalan Sign Language	Guatemalan Sign Language
gsn	Gusan	Gusan
gsp	Wasembo	Wasembo
gss	Greek Sign Language	Greek Sign Language
gsw	Alemannic	Alemannic
gsw	Swiss German	German, Swiss
gta	Guató	Guató
gti	Gbati-ri	Gbati-ri
gua	Shiki	Shiki
gub	Guajajára	Guajajára
guc	Wayuu	Wayuu
gud	Yocoboué Dida	Dida, Yocoboué
gue	Gurinji	Gurinji
guf	Gupapuyngu	Gupapuyngu
gug	Paraguayan Guaraní	Guaraní, Paraguayan
guh	Guahibo	Guahibo
gui	Eastern Bolivian Guaraní	Guaraní, Eastern Bolivian
guj	Gujarati	Gujarati
guk	Gumuz	Gumuz
gul	Sea Island Creole English	Creole English, Sea Island
gum	Guambiano	Guambiano
gun	Mbyá Guaraní	Guaraní, Mbyá
guo	Guayabero	Guayabero
gup	Gunwinggu	Gunwinggu
guq	Aché	Aché
gur	Farefare	Farefare
gus	Guinean Sign Language	Guinean Sign Language
gut	Maléku Jaíka	Maléku Jaíka
guu	Yanomamö	Yanomamö
guv	Gey	Gey
guw	Gun	Gun
gux	Gourmanchéma	Gourmanchéma
guz	Gusii	Gusii
gva	Guana (Paraguay)	Guana (Paraguay)
gvc	Guanano	Guanano
gve	Duwet	Duwet
gvf	Golin	Golin
gvj	Guajá	Guajá
gvl	Gulay	Gulay
gvm	Gurmana	Gurmana
gvn	Kuku-Yalanji	Kuku-Yalanji
gvo	Gavião Do Jiparaná	Gavião Do Jiparaná
gvp	Pará Gavião	Gavião, Pará
gvr	Western Gurung	Gurung, Western
gvs	Gumawana	Gumawana
gvy	Guyani	Guyani
gwa	Mbato	Mbato
gwb	Gwa	Gwa
gwc	Kalami	Kalami
gwd	Gawwada	Gawwada
gwe	Gweno	Gweno
gwf	Gowro	Gowro
gwg	Moo	Moo
gwi	Gwichʼin	Gwichʼin
gwj	/Gwi	/Gwi
gwn	Gwandara	Gwandara
gwr	Gwere	Gwere
gwt	Gawar-Bati	Gawar-Bati
gwu	Guwamu	Guwamu
gww	Kwini	Kwini
gwx	Gua	Gua
gxx	Wè Southern	Wè Southern
gya	Northwest Gbaya	Gbaya, Northwest
gyb	Garus	Garus
gyd	Kayardild	Kayardild
gye	Gyem	Gyem
gyf	Gungabula	Gungabula
gyg	Gbayi	Gbayi
gyi	Gyele	Gyele
gym	Ngäbere	Ngäbere
gyn	Guyanese Creole English	Creole English, Guyanese
gyr	Guarayu	Guarayu
gyy	Gunya	Gunya
gza	Ganza	Ganza
gzi	Gazi	Gazi
gzn	Gane	Gane
haa	Han	Han
hab	Hanoi Sign Language	Hanoi Sign Language
hac	Gurani	Gurani
had	Hatam	Hatam
hae	Eastern Oromo	Oromo, Eastern
haf	Haiphong Sign Language	Haiphong Sign Language
hag	Hanga	Hanga
hah	Hahon	Hahon
hai	Haida	Haida
haj	Hajong	Hajong
hak	Hakka Chinese	Chinese, Hakka
hal	Halang	Halang
ham	Hewa	Hewa
han	Hangaza	Hangaza
hao	Hakö	Hakö
hap	Hupla	Hupla
haq	Ha	Ha
har	Harari	Harari
has	Haisla	Haisla
hat	Haitian	Haitian
hat	Haitian Creole	Creole, Haitian
hau	Hausa	Hausa
hav	Havu	Havu
haw	Hawaiian	Hawaiian
hax	Southern Haida	Haida, Southern
hay	Haya	Haya
haz	Hazaragi	Hazaragi
hba	Hamba	Hamba
hbb	Huba	Huba
hbn	Heiban	Heiban
hbo	Ancient Hebrew	Hebrew, Ancient
hbs	Serbo-Croatian	Serbo-Croatian
hbu	Habu	Habu
hca	Andaman Creole Hindi	Creole Hindi, Andaman
hch	Huichol	Huichol
hdn	Northern Haida	Haida, Northern
hds	Honduras Sign Language	Honduras Sign Language
hdy	Hadiyya	Hadiyya
hea	Northern Qiandong Hmong	Hmong, Northern Qiandong
heb	Hebrew	Hebrew
hed	Herdé	Herdé
heg	Helong	Helong
heh	Hehe	Hehe
hei	Heiltsuk	Heiltsuk
hem	Hemba	Hemba
her	Herero	Herero
hgm	Hai//om	Hai//om
hgw	Haigwai	Haigwai
hhi	Hoia Hoia	Hoia Hoia
hhr	Kerak	Kerak
hhy	Hoyahoya	Hoyahoya
hia	Lamang	Lamang
hib	Hibito	Hibito
hid	Hidatsa	Hidatsa
hif	Fijian Hindustani	Hindustani, Fijian
hig	Kamwe	Kamwe
hih	Pamosu	Pamosu
hii	Hinduri	Hinduri
hij	Hijuk	Hijuk
hik	Seit-Kaitetu	Seit-Kaitetu
hil	Hiligaynon	Hiligaynon
hin	Hindi	Hindi
hio	Tsoa	Tsoa
hir	Himarimã	Himarimã
hit	Hittite	Hittite
hiw	Hiw	Hiw
hix	Hixkaryána	Hixkaryána
hka	Kahe	Kahe
hke	Hunde	Hunde
hla	Halia	Halia
hlb	Halbi	Halbi
hld	Halang Doan	Halang Doan
hlt	Nga La	Nga La
hlu	Hieroglyphic Luwian	Luwian, Hieroglyphic
hma	Southern Mashan Hmong	Hmong, Southern Mashan
hmb	Humburi Senni Songhay	Songhay, Humburi Senni
hmc	Central Huishui Hmong	Hmong, Central Huishui
hmd	Northeastern Dian Hmong	Hmong, Northeastern Dian
hme	Eastern Huishui Hmong	Hmong, Eastern Huishui
hmf	Hmong Don	Hmong Don
hmg	Southwestern Guiyang Hmong	Hmong, Southwestern Guiyang
hmh	Southwestern Huishui Hmong	Hmong, Southwestern Huishui
hmi	Northern Huishui Hmong	Hmong, Northern Huishui
hmj	Chonganjiang Hmong	Hmong, Chonganjiang
hmk	Maek	Maek
hml	Luopohe Hmong	Hmong, Luopohe
hmm	Central Mashan Hmong	Hmong, Central Mashan
hmn	Hmong	Hmong
hmo	Hiri Motu	Hiri Motu
hmp	Northern Mashan Hmong	Hmong, Northern Mashan
hmq	Eastern Qiandong Hmong	Hmong, Eastern Qiandong
hmr	Hmar	Hmar
hms	Southern Qiandong Hmong	Hmong, Southern Qiandong
hmt	Hamtai	Hamtai
hmu	Hamap	Hamap
hmv	Hmong Dô	Hmong Dô
hmw	Western Mashan Hmong	Hmong, Western Mashan
hmy	Southern Guiyang Hmong	Hmong, Southern Guiyang
hmz	Hmong Shua	Hmong Shua
hna	Mina (Cameroon)	Mina (Cameroon)
hnd	Southern Hindko	Hindko, Southern
hne	Chhattisgarhi	Chhattisgarhi
hnh	//Ani	//Ani
hni	Hani	Hani
hnn	Hanunoo	Hanunoo
hno	Northern Hindko	Hindko, Northern
hns	Caribbean Hindustani	Hindustani, Caribbean
hnu	Hung	Hung
hoa	Hoava	Hoava
hob	Mari (Madang Province)	Mari (Madang Province)
hoc	Ho	Ho
hod	Holma	Holma
hoe	Horom	Horom
hoh	Hobyót	Hobyót
hoi	Holikachuk	Holikachuk
hoj	Harauti	Harauti
hol	Holu	Holu
hom	Homa	Homa
hoo	Holoholo	Holoholo
hop	Hopi	Hopi
hor	Horo	Horo
hos	Ho Chi Minh City Sign Language	Ho Chi Minh City Sign Language
hot	Hote	Hote
hov	Hovongan	Hovongan
how	Honi	Honi
hoy	Holiya	Holiya
hoz	Hozo	Hozo
hpo	Hpon	Hpon
hps	Hawai'i Pidgin Sign Language	Hawai'i Pidgin Sign Language
hra	Hrangkhol	Hrangkhol
hre	Hre	Hre
hrk	Haruku	Haruku
hro	Haroi	Haroi
hrr	Horuru	Horuru
hrt	Hértevin	Hértevin
hru	Hruso	Hruso
hrv	Croatian	Croatian
hrx	Hunsrik	Hunsrik
hrz	Harzani	Harzani
hsb	Upper Sorbian	Sorbian, Upper
hsf	Southeastern Huastec	Huastec, Southeastern
hsh	Hungarian Sign Language	Hungarian Sign Language
hsl	Hausa Sign Language	Hausa Sign Language
hsn	Xiang Chinese	Chinese, Xiang
hss	Harsusi	Harsusi
hti	Hoti	Hoti
hto	Minica Huitoto	Huitoto, Minica
hts	Hadza	Hadza
htu	Hitu	Hitu
htx	Middle Hittite	Hittite, Middle
hub	Huambisa	Huambisa
huc	=/Hua	=/Hua
hud	Huaulu	Huaulu
hue	San Francisco Del Mar Huave	Huave, San Francisco Del Mar
huf	Humene	Humene
hug	Huachipaeri	Huachipaeri
huh	Huilliche	Huilliche
hui	Huli	Huli
huj	Northern Guiyang Hmong	Hmong, Northern Guiyang
huk	Hulung	Hulung
hul	Hula	Hula
hum	Hungana	Hungana
hun	Hungarian	Hungarian
huo	Hu	Hu
hup	Hupa	Hupa
huq	Tsat	Tsat
hur	Halkomelem	Halkomelem
hus	Veracruz Huastec	Huastec, Veracruz
hut	Humla	Humla
huu	Murui Huitoto	Huitoto, Murui
huv	San Mateo Del Mar Huave	Huave, San Mateo Del Mar
huw	Hukumina	Hukumina
hux	Nüpode Huitoto	Huitoto, Nüpode
huy	Hulaulá	Hulaulá
huz	Hunzib	Hunzib
hva	San Luís Potosí Huastec	Huastec, San Luís Potosí
hvc	Haitian Vodoun Culture Language	Haitian Vodoun Culture Language
hve	San Dionisio Del Mar Huave	Huave, San Dionisio Del Mar
hvk	Haveke	Haveke
hvn	Sabu	Sabu
hvv	Santa María Del Mar Huave	Huave, Santa María Del Mar
hwa	Wané	Wané
hwc	Hawai'i Creole English	Creole English, Hawai'i
hwo	Hwana	Hwana
hya	Hya	Hya
hye	Armenian	Armenian
iai	Iaai	Iaai
ian	Iatmul	Iatmul
iap	Iapama	Iapama
iar	Purari	Purari
iba	Iban	Iban
ibb	Ibibio	Ibibio
ibd	Iwaidja	Iwaidja
ibe	Akpes	Akpes
ibg	Ibanag	Ibanag
ibi	Ibilo	Ibilo
ibl	Ibaloi	Ibaloi
ibm	Agoi	Agoi
ibn	Ibino	Ibino
ibo	Igbo	Igbo
ibr	Ibuoro	Ibuoro
ibu	Ibu	Ibu
iby	Ibani	Ibani
ica	Ede Ica	Ede Ica
ich	Etkywan	Etkywan
icl	Icelandic Sign Language	Icelandic Sign Language
icr	Islander Creole English	Creole English, Islander
ida	Idakho-Isukha-Tiriki	Idakho-Isukha-Tiriki
idb	Indo-Portuguese	Indo-Portuguese
idc	Idon	Idon
idd	Ede Idaca	Ede Idaca
ide	Idere	Idere
idi	Idi	Idi
ido	Ido	Ido
idr	Indri	Indri
ids	Idesa	Idesa
idt	Idaté	Idaté
idu	Idoma	Idoma
ifa	Amganad Ifugao	Ifugao, Amganad
ifb	Batad Ifugao	Ifugao, Batad
ife	Ifè	Ifè
iff	Ifo	Ifo
ifk	Tuwali Ifugao	Ifugao, Tuwali
ifm	Teke-Fuumu	Teke-Fuumu
ifu	Mayoyao Ifugao	Ifugao, Mayoyao
ify	Keley-I Kallahan	Kallahan, Keley-I
igb	Ebira	Ebira
ige	Igede	Igede
igg	Igana	Igana
igl	Igala	Igala
igm	Kanggape	Kanggape
ign	Ignaciano	Ignaciano
igo	Isebe	Isebe
igs	Interglossa	Interglossa
igw	Igwe	Igwe
ihb	Iha Based Pidgin	Iha Based Pidgin
ihi	Ihievbe	Ihievbe
ihp	Iha	Iha
iii	Sichuan Yi	Yi, Sichuan
ijc	Izon	Izon
ije	Biseni	Biseni
ijj	Ede Ije	Ede Ije
ijn	Kalabari	Kalabari
ijs	Southeast Ijo	Ijo, Southeast
ike	Eastern Canadian Inuktitut	Inuktitut, Eastern Canadian
iki	Iko	Iko
ikk	Ika	Ika
ikl	Ikulu	Ikulu
iko	Olulumo-Ikom	Olulumo-Ikom
ikp	Ikpeshi	Ikpeshi
ikt	Western Canadian Inuktitut	Inuktitut, Western Canadian
iku	Inuktitut	Inuktitut
ikv	Iku-Gora-Ankwa	Iku-Gora-Ankwa
ikw	Ikwere	Ikwere
ikx	Ik	Ik
ikz	Ikizu	Ikizu
ila	Ile Ape	Ile Ape
ilb	Ila	Ila
ile	Interlingue	Interlingue
ilg	Garig-Ilgar	Garig-Ilgar
ili	Ili Turki	Ili Turki
ilk	Ilongot	Ilongot
ill	Iranun	Iranun
ilo	Iloko	Iloko
ilu	Ili'uun	Ili'uun
ilv	Ilue	Ilue
ilw	Talur	Talur
ima	Mala Malasar	Malasar, Mala
ime	Imeraguen	Imeraguen
imi	Anamgura	Anamgura
iml	Miluk	Miluk
imn	Imonda	Imonda
imo	Imbongu	Imbongu
imr	Imroing	Imroing
ims	Marsian	Marsian
imy	Milyan	Milyan
ina	Interlingua (International Auxiliary Language Association)	Interlingua (International Auxiliary Language Association)
inb	Inga	Inga
ind	Indonesian	Indonesian
ing	Degexit'an	Degexit'an
inh	Ingush	Ingush
inj	Jungle Inga	Inga, Jungle
inl	Indonesian Sign Language	Indonesian Sign Language
inm	Minaean	Minaean
inn	Isinai	Isinai
ino	Inoke-Yate	Inoke-Yate
inp	Iñapari	Iñapari
ins	Indian Sign Language	Indian Sign Language
int	Intha	Intha
inz	Ineseño	Ineseño
ior	Inor	Inor
iou	Tuma-Irumu	Tuma-Irumu
iow	Iowa-Oto	Iowa-Oto
ipi	Ipili	Ipili
ipk	Inupiaq	Inupiaq
ipo	Ipiko	Ipiko
iqu	Iquito	Iquito
ire	Iresim	Iresim
irh	Irarutu	Irarutu
iri	Irigwe	Irigwe
irk	Iraqw	Iraqw
irn	Irántxe	Irántxe
irr	Ir	Ir
iru	Irula	Irula
irx	Kamberau	Kamberau
iry	Iraya	Iraya
isa	Isabi	Isabi
isc	Isconahua	Isconahua
isd	Isnag	Isnag
ise	Italian Sign Language	Italian Sign Language
isg	Irish Sign Language	Irish Sign Language
ish	Esan	Esan
isi	Nkem-Nkum	Nkem-Nkum
isl	Icelandic	Icelandic
ism	Masimasi	Masimasi
isn	Isanzu	Isanzu
iso	Isoko	Isoko
isr	Israeli Sign Language	Israeli Sign Language
ist	Istriot	Istriot
isu	Isu (Menchum Division)	Isu (Menchum Division)
ita	Italian	Italian
itb	Binongan Itneg	Itneg, Binongan
ite	Itene	Itene
iti	Inlaod Itneg	Itneg, Inlaod
itk	Judeo-Italian	Judeo-Italian
itl	Itelmen	Itelmen
itm	Itu Mbon Uzo	Itu Mbon Uzo
ito	Itonama	Itonama
itr	Iteri	Iteri
its	Isekiri	Isekiri
itt	Maeng Itneg	Itneg, Maeng
itu	Itutang	Itutang
itv	Itawit	Itawit
itw	Ito	Ito
itx	Itik	Itik
ity	Moyadan Itneg	Itneg, Moyadan
itz	Itzá	Itzá
ium	Iu Mien	Mien, Iu
ivb	Ibatan	Ibatan
ivv	Ivatan	Ivatan
iwk	I-Wak	I-Wak
iwm	Iwam	Iwam
iwo	Iwur	Iwur
iws	Sepik Iwam	Iwam, Sepik
ixc	Ixcatec	Ixcatec
ixi	Nebaj Ixil	Ixil, Nebaj
ixj	Chajul Ixil	Ixil, Chajul
ixl	San Juan Cotzal Ixil	Ixil, San Juan Cotzal
iya	Iyayu	Iyayu
iyo	Mesaka	Mesaka
iyx	Yaka (Congo)	Yaka (Congo)
izh	Ingrian	Ingrian
izi	Izi-Ezaa-Ikwo-Mgbo	Izi-Ezaa-Ikwo-Mgbo
jaa	Jamamadí	Jamamadí
jab	Hyam	Hyam
jac	Eastern Jacalteco	Jacalteco, Eastern
jad	Jahanka	Jahanka
jae	Yabem	Yabem
jaf	Jara	Jara
jah	Jah Hut	Jah Hut
jai	Western Jacalteco	Jacalteco, Western
jaj	Zazao	Zazao
jak	Jakun	Jakun
jal	Yalahatan	Yalahatan
jam	Jamaican Creole English	Creole English, Jamaican
jao	Yanyuwa	Yanyuwa
jaq	Yaqay	Yaqay
jar	Jarawa (Nigeria)	Jarawa (Nigeria)
jas	New Caledonian Javanese	Javanese, New Caledonian
jat	Jakati	Jakati
jau	Yaur	Yaur
jav	Javanese	Javanese
jax	Jambi Malay	Malay, Jambi
jay	Jarnango	Jarnango
jaz	Jawe	Jawe
jbe	Judeo-Berber	Judeo-Berber
jbj	Arandai	Arandai
jbn	Nafusi	Nafusi
jbo	Lojban	Lojban
jbt	Jabutí	Jabutí
jbu	Jukun Takum	Jukun Takum
jcs	Jamaican Country Sign Language	Jamaican Country Sign Language
jct	Krymchak	Krymchak
jda	Jad	Jad
jdg	Jadgali	Jadgali
jdt	Judeo-Tat	Judeo-Tat
jeb	Jebero	Jebero
jee	Jerung	Jerung
jeg	Jeng	Jeng
jeh	Jeh	Jeh
jei	Yei	Yei
jek	Jeri Kuo	Jeri Kuo
jel	Yelmek	Yelmek
jen	Dza	Dza
jer	Jere	Jere
jet	Manem	Manem
jeu	Jonkor Bourmataguil	Jonkor Bourmataguil
jgb	Ngbee	Ngbee
jge	Judeo-Georgian	Judeo-Georgian
jgo	Ngomba	Ngomba
jhi	Jehai	Jehai
jia	Jina	Jina
jib	Jibu	Jibu
jic	Tol	Tol
jid	Bu	Bu
jie	Jilbe	Jilbe
jig	Djingili	Djingili
jih	Shangzhai	Shangzhai
jii	Jiiddu	Jiiddu
jil	Jilim	Jilim
jim	Jimi (Cameroon)	Jimi (Cameroon)
jio	Jiamao	Jiamao
jiq	Guanyinqiao	Guanyinqiao
jit	Jita	Jita
jiu	Youle Jinuo	Jinuo, Youle
jiv	Shuar	Shuar
jiy	Buyuan Jinuo	Jinuo, Buyuan
jko	Kubo	Kubo
jku	Labir	Labir
jle	Ngile	Ngile
jma	Dima	Dima
jmb	Zumbun	Zumbun
jmc	Machame	Machame
jmd	Yamdena	Yamdena
jmi	Jimi (Nigeria)	Jimi (Nigeria)
jml	Jumli	Jumli
jmr	Kamara	Kamara
jms	Mashi (Nigeria)	Mashi (Nigeria)
jmx	Western Juxtlahuaca Mixtec	Mixtec, Western Juxtlahuaca
jna	Jangshung	Jangshung
jnd	Jandavra	Jandavra
jng	Yangman	Yangman
jni	Janji	Janji
jnj	Yemsa	Yemsa
jnl	Rawat	Rawat
jns	Jaunsari	Jaunsari
job	Joba	Joba
jod	Wojenaka	Wojenaka
jor	Jorá	Jorá
jos	Jordanian Sign Language	Jordanian Sign Language
jow	Jowulu	Jowulu
jpa	Jewish Palestinian Aramaic	Aramaic, Jewish Palestinian
jpn	Japanese	Japanese
jpr	Judeo-Persian	Judeo-Persian
jqr	Jaqaru	Jaqaru
jra	Jarai	Jarai
jrb	Judeo-Arabic	Judeo-Arabic
jrr	Jiru	Jiru
jrt	Jorto	Jorto
jru	Japrería	Japrería
jsl	Japanese Sign Language	Japanese Sign Language
jua	Júma	Júma
jub	Wannu	Wannu
juc	Jurchen	Jurchen
jud	Worodougou	Worodougou
juh	Hõne	Hõne
juk	Wapan	Wapan
jul	Jirel	Jirel
jum	Jumjum	Jumjum
jun	Juang	Juang
juo	Jiba	Jiba
jup	Hupdë	Hupdë
jur	Jurúna	Jurúna
jut	Jutish	Jutish
juu	Ju	Ju
juw	Wãpha	Wãpha
juy	Juray	Juray
jvd	Javindo	Javindo
jvn	Caribbean Javanese	Javanese, Caribbean
jwi	Jwira-Pepesa	Jwira-Pepesa
jya	Jiarong	Jiarong
jye	Judeo-Yemeni Arabic	Arabic, Judeo-Yemeni
jyy	Jaya	Jaya
kaa	Kara-Kalpak	Kara-Kalpak
kab	Kabyle	Kabyle
kac	Jingpho	Jingpho
kac	Kachin	Kachin
kad	Kadara	Kadara
kae	Ketangalan	Ketangalan
kaf	Katso	Katso
kag	Kajaman	Kajaman
kah	Kara (Central African Republic)	Kara (Central African Republic)
kai	Karekare	Karekare
kaj	Jju	Jju
kak	Kayapa Kallahan	Kallahan, Kayapa
kal	Greenlandic	Greenlandic
kal	Kalaallisut	Kalaallisut
kam	Kamba (Kenya)	Kamba (Kenya)
kan	Kannada	Kannada
kao	Xaasongaxango	Xaasongaxango
kap	Bezhta	Bezhta
kaq	Capanahua	Capanahua
kas	Kashmiri	Kashmiri
kat	Georgian	Georgian
kau	Kanuri	Kanuri
kav	Katukína	Katukína
kaw	Kawi	Kawi
kax	Kao	Kao
kay	Kamayurá	Kamayurá
kaz	Kazakh	Kazakh
kba	Kalarko	Kalarko
kbb	Kaxuiâna	Kaxuiâna
kbc	Kadiwéu	Kadiwéu
kbd	Kabardian	Kabardian
kbe	Kanju	Kanju
kbf	Kakauhua	Kakauhua
kbg	Khamba	Khamba
kbh	Camsá	Camsá
kbj	Kari	Kari
kbk	Grass Koiari	Koiari, Grass
kbl	Kanembu	Kanembu
kbm	Iwal	Iwal
kbn	Kare (Central African Republic)	Kare (Central African Republic)
kbo	Keliko	Keliko
kbp	Kabiyé	Kabiyé
kbq	Kamano	Kamano
kbr	Kafa	Kafa
kbs	Kande	Kande
kbt	Abadi	Abadi
kbu	Kabutra	Kabutra
kbv	Dera (Indonesia)	Dera (Indonesia)
kbw	Kaiep	Kaiep
kbx	Ap Ma	Ap Ma
kby	Manga Kanuri	Kanuri, Manga
kbz	Duhwa	Duhwa
kca	Khanty	Khanty
kcb	Kawacha	Kawacha
kcc	Lubila	Lubila
kcd	Ngkâlmpw Kanum	Kanum, Ngkâlmpw
kce	Kaivi	Kaivi
kcf	Ukaan	Ukaan
kcg	Tyap	Tyap
kch	Vono	Vono
kci	Kamantan	Kamantan
kcj	Kobiana	Kobiana
kck	Kalanga	Kalanga
kcl	Kela (Papua New Guinea)	Kela (Papua New Guinea)
kcm	Gula (Central African Republic)	Gula (Central African Republic)
kcn	Nubi	Nubi
kco	Kinalakna	Kinalakna
kcp	Kanga	Kanga
kcq	Kamo	Kamo
kcr	Katla	Katla
kcs	Koenoem	Koenoem
kct	Kaian	Kaian
kcu	Kami (Tanzania)	Kami (Tanzania)
kcv	Kete	Kete
kcw	Kabwari	Kabwari
kcx	Kachama-Ganjule	Kachama-Ganjule
kcy	Korandje	Korandje
kcz	Konongo	Konongo
kda	Worimi	Worimi
kdc	Kutu	Kutu
kdd	Yankunytjatjara	Yankunytjatjara
kde	Makonde	Makonde
kdf	Mamusi	Mamusi
kdg	Seba	Seba
kdh	Tem	Tem
kdi	Kumam	Kumam
kdj	Karamojong	Karamojong
kdk	Numee	Numee
kdl	Tsikimba	Tsikimba
kdm	Kagoma	Kagoma
kdn	Kunda	Kunda
kdp	Kaningdon-Nindem	Kaningdon-Nindem
kdq	Koch	Koch
kdr	Karaim	Karaim
kds	Lahu Shi	Lahu Shi
kdt	Kuy	Kuy
kdu	Kadaru	Kadaru
kdv	Kado	Kado
kdw	Koneraw	Koneraw
kdx	Kam	Kam
kdy	Keder	Keder
kdz	Kwaja	Kwaja
kea	Kabuverdianu	Kabuverdianu
keb	Kélé	Kélé
kec	Keiga	Keiga
ked	Kerewe	Kerewe
kee	Eastern Keres	Keres, Eastern
kef	Kpessi	Kpessi
keg	Tese	Tese
kei	Kei	Kei
kej	Kadar	Kadar
kek	Kekchí	Kekchí
kel	Kela (Democratic Republic of Congo)	Kela (Democratic Republic of Congo)
kem	Kemak	Kemak
ken	Kenyang	Kenyang
keo	Kakwa	Kakwa
kep	Kaikadi	Kaikadi
keq	Kamar	Kamar
ker	Kera	Kera
kes	Kugbo	Kugbo
ket	Ket	Ket
keu	Akebu	Akebu
kev	Kanikkaran	Kanikkaran
kew	West Kewa	Kewa, West
kex	Kukna	Kukna
key	Kupia	Kupia
kez	Kukele	Kukele
kfa	Kodava	Kodava
kfb	Northwestern Kolami	Kolami, Northwestern
kfc	Konda-Dora	Konda-Dora
kfd	Korra Koraga	Koraga, Korra
kfe	Kota (India)	Kota (India)
kff	Koya	Koya
kfg	Kudiya	Kudiya
kfh	Kurichiya	Kurichiya
kfi	Kannada Kurumba	Kurumba, Kannada
kfj	Kemiehua	Kemiehua
kfk	Kinnauri	Kinnauri
kfl	Kung	Kung
kfm	Khunsari	Khunsari
kfn	Kuk	Kuk
kfo	Koro (Côte d'Ivoire)	Koro (Côte d'Ivoire)
kfp	Korwa	Korwa
kfq	Korku	Korku
kfr	Kachchi	Kachchi
kfs	Bilaspuri	Bilaspuri
kft	Kanjari	Kanjari
kfu	Katkari	Katkari
kfv	Kurmukar	Kurmukar
kfw	Kharam Naga	Naga, Kharam
kfx	Kullu Pahari	Pahari, Kullu
kfy	Kumaoni	Kumaoni
kfz	Koromfé	Koromfé
kga	Koyaga	Koyaga
kgb	Kawe	Kawe
kgc	Kasseng	Kasseng
kgd	Kataang	Kataang
kge	Komering	Komering
kgf	Kube	Kube
kgg	Kusunda	Kusunda
kgh	Upper Tanudan Kalinga	Kalinga, Upper Tanudan
kgi	Selangor Sign Language	Selangor Sign Language
kgj	Gamale Kham	Kham, Gamale
kgk	Kaiwá	Kaiwá
kgl	Kunggari	Kunggari
kgm	Karipúna	Karipúna
kgn	Karingani	Karingani
kgo	Krongo	Krongo
kgp	Kaingang	Kaingang
kgq	Kamoro	Kamoro
kgr	Abun	Abun
kgs	Kumbainggar	Kumbainggar
kgt	Somyev	Somyev
kgu	Kobol	Kobol
kgv	Karas	Karas
kgw	Karon Dori	Karon Dori
kgx	Kamaru	Kamaru
kgy	Kyerung	Kyerung
kha	Khasi	Khasi
khb	Lü	Lü
khc	Tukang Besi North	Tukang Besi North
khd	Bädi Kanum	Kanum, Bädi
khe	Korowai	Korowai
khf	Khuen	Khuen
khg	Khams Tibetan	Tibetan, Khams
khh	Kehu	Kehu
khj	Kuturmi	Kuturmi
khk	Halh Mongolian	Mongolian, Halh
khl	Lusi	Lusi
khm	Central Khmer	Khmer, Central
khn	Khandesi	Khandesi
kho	Khotanese	Khotanese
khp	Kapori	Kapori
khq	Koyra Chiini Songhay	Songhay, Koyra Chiini
khr	Kharia	Kharia
khs	Kasua	Kasua
kht	Khamti	Khamti
khu	Nkhumbi	Nkhumbi
khv	Khvarshi	Khvarshi
khw	Khowar	Khowar
khx	Kanu	Kanu
khy	Kele (Democratic Republic of Congo)	Kele (Democratic Republic of Congo)
khz	Keapara	Keapara
kia	Kim	Kim
kib	Koalib	Koalib
kic	Kickapoo	Kickapoo
kid	Koshin	Koshin
kie	Kibet	Kibet
kif	Eastern Parbate Kham	Kham, Eastern Parbate
kig	Kimaama	Kimaama
kih	Kilmeri	Kilmeri
kii	Kitsai	Kitsai
kij	Kilivila	Kilivila
kik	Gikuyu	Gikuyu
kik	Kikuyu	Kikuyu
kil	Kariya	Kariya
kim	Karagas	Karagas
kin	Kinyarwanda	Kinyarwanda
kio	Kiowa	Kiowa
kip	Sheshi Kham	Kham, Sheshi
kiq	Kosadle	Kosadle
kir	Kirghiz	Kirghiz
kir	Kyrgyz	Kyrgyz
kis	Kis	Kis
kit	Agob	Agob
kiu	Kirmanjki	Kirmanjki
kiv	Kimbu	Kimbu
kiw	Northeast Kiwai	Kiwai, Northeast
kiy	Kirikiri	Kirikiri
kiz	Kisi	Kisi
kja	Mlap	Mlap
kjb	Eastern Kanjobal	Kanjobal, Eastern
kjc	Coastal Konjo	Konjo, Coastal
kjd	Southern Kiwai	Kiwai, Southern
kje	Kisar	Kisar
kjf	Khalaj	Khalaj
kjg	Khmu	Khmu
kjh	Khakas	Khakas
kji	Zabana	Zabana
kjj	Khinalugh	Khinalugh
kjk	Highland Konjo	Konjo, Highland
kjl	Western Parbate Kham	Kham, Western Parbate
kjm	Kháng	Kháng
kjn	Kunjen	Kunjen
kjo	Harijan Kinnauri	Kinnauri, Harijan
kjp	Pwo Eastern Karen	Karen, Pwo Eastern
kjq	Western Keres	Keres, Western
kjr	Kurudu	Kurudu
kjs	East Kewa	Kewa, East
kjt	Phrae Pwo Karen	Karen, Phrae Pwo
kju	Kashaya	Kashaya
kjx	Ramopa	Ramopa
kjy	Erave	Erave
kjz	Bumthangkha	Bumthangkha
kka	Kakanda	Kakanda
kkb	Kwerisa	Kwerisa
kkc	Odoodee	Odoodee
kkd	Kinuku	Kinuku
kke	Kakabe	Kakabe
kkf	Kalaktang Monpa	Monpa, Kalaktang
kkg	Mabaka Valley Kalinga	Kalinga, Mabaka Valley
kkh	Khün	Khün
kki	Kagulu	Kagulu
kkj	Kako	Kako
kkk	Kokota	Kokota
kkl	Kosarek Yale	Yale, Kosarek
kkm	Kiong	Kiong
kkn	Kon Keu	Kon Keu
kko	Karko	Karko
kkp	Gugubera	Gugubera
kkq	Kaiku	Kaiku
kkr	Kir-Balar	Kir-Balar
kks	Giiwo	Giiwo
kkt	Koi	Koi
kku	Tumi	Tumi
kkv	Kangean	Kangean
kkw	Teke-Kukuya	Teke-Kukuya
kkx	Kohin	Kohin
kky	Guguyimidjir	Guguyimidjir
kkz	Kaska	Kaska
kla	Klamath-Modoc	Klamath-Modoc
klb	Kiliwa	Kiliwa
klc	Kolbila	Kolbila
kld	Gamilaraay	Gamilaraay
kle	Kulung (Nepal)	Kulung (Nepal)
klf	Kendeje	Kendeje
klg	Tagakaulu Kalagan	Kalagan, Tagakaulu
klh	Weliki	Weliki
kli	Kalumpang	Kalumpang
klj	Turkic Khalaj	Khalaj, Turkic
klk	Kono (Nigeria)	Kono (Nigeria)
kll	Kagan Kalagan	Kalagan, Kagan
klm	Kolom	Kolom
kln	Kalenjin	Kalenjin
klo	Kapya	Kapya
klp	Kamasa	Kamasa
klq	Rumu	Rumu
klr	Khaling	Khaling
kls	Kalasha	Kalasha
klt	Nukna	Nukna
klu	Klao	Klao
klv	Maskelynes	Maskelynes
klw	Lindu	Lindu
klx	Koluwawa	Koluwawa
kly	Kalao	Kalao
klz	Kabola	Kabola
kma	Konni	Konni
kmb	Kimbundu	Kimbundu
kmc	Southern Dong	Dong, Southern
kmd	Madukayang Kalinga	Kalinga, Madukayang
kme	Bakole	Bakole
kmf	Kare (Papua New Guinea)	Kare (Papua New Guinea)
kmg	Kâte	Kâte
kmh	Kalam	Kalam
kmi	Kami (Nigeria)	Kami (Nigeria)
kmj	Kumarbhag Paharia	Kumarbhag Paharia
kmk	Limos Kalinga	Kalinga, Limos
kml	Lower Tanudan Kalinga	Kalinga, Lower Tanudan
kmm	Kom (India)	Kom (India)
kmn	Awtuw	Awtuw
kmo	Kwoma	Kwoma
kmp	Gimme	Gimme
kmq	Kwama	Kwama
kmr	Northern Kurdish	Kurdish, Northern
kms	Kamasau	Kamasau
kmt	Kemtuik	Kemtuik
kmu	Kanite	Kanite
kmv	Karipúna Creole French	Creole French, Karipúna
kmw	Komo (Democratic Republic of Congo)	Komo (Democratic Republic of Congo)
kmx	Waboda	Waboda
kmy	Koma	Koma
kmz	Khorasani Turkish	Khorasani Turkish
kna	Dera (Nigeria)	Dera (Nigeria)
knb	Lubuagan Kalinga	Kalinga, Lubuagan
knc	Central Kanuri	Kanuri, Central
knd	Konda	Konda
kne	Kankanaey	Kankanaey
knf	Mankanya	Mankanya
kng	Koongo	Koongo
knh	Kayan River Kenyah	Kenyah, Kayan River
kni	Kanufi	Kanufi
knj	Western Kanjobal	Kanjobal, Western
knk	Kuranko	Kuranko
knl	Keninjal	Keninjal
knm	Kanamarí	Kanamarí
knn	Konkani (individual language)	Konkani (individual language)
kno	Kono (Sierra Leone)	Kono (Sierra Leone)
knp	Kwanja	Kwanja
knq	Kintaq	Kintaq
knr	Kaningra	Kaningra
kns	Kensiu	Kensiu
knt	Panoan Katukína	Katukína, Panoan
knu	Kono (Guinea)	Kono (Guinea)
knv	Tabo	Tabo
knw	Kung-Ekoka	Kung-Ekoka
knx	Kendayan	Kendayan
kny	Kanyok	Kanyok
knz	Kalamsé	Kalamsé
koa	Konomala	Konomala
koc	Kpati	Kpati
kod	Kodi	Kodi
koe	Kacipo-Balesi	Kacipo-Balesi
kof	Kubi	Kubi
kog	Cogui	Cogui
koh	Koyo	Koyo
koi	Komi-Permyak	Komi-Permyak
koj	Sara Dunjo	Sara Dunjo
kok	Konkani (macrolanguage)	Konkani (macrolanguage)
kol	Kol (Papua New Guinea)	Kol (Papua New Guinea)
kom	Komi	Komi
kon	Kongo	Kongo
koo	Konzo	Konzo
kop	Kwato	Kwato
koq	Kota (Gabon)	Kota (Gabon)
kor	Korean	Korean
kos	Kosraean	Kosraean
kot	Lagwan	Lagwan
kou	Koke	Koke
kov	Kudu-Camo	Kudu-Camo
kow	Kugama	Kugama
kox	Coxima	Coxima
koy	Koyukon	Koyukon
koz	Korak	Korak
kpa	Kutto	Kutto
kpb	Mullu Kurumba	Kurumba, Mullu
kpc	Curripaco	Curripaco
kpd	Koba	Koba
kpe	Kpelle	Kpelle
kpf	Komba	Komba
kpg	Kapingamarangi	Kapingamarangi
kph	Kplang	Kplang
kpi	Kofei	Kofei
kpj	Karajá	Karajá
kpk	Kpan	Kpan
kpl	Kpala	Kpala
kpm	Koho	Koho
kpn	Kepkiriwát	Kepkiriwát
kpo	Ikposo	Ikposo
kpp	Paku Karen	Karen, Paku
kpq	Korupun-Sela	Korupun-Sela
kpr	Korafe	Korafe
kps	Tehit	Tehit
kpt	Karata	Karata
kpu	Kafoa	Kafoa
kpv	Komi-Zyrian	Komi-Zyrian
kpw	Kobon	Kobon
kpx	Mountain Koiali	Koiali, Mountain
kpy	Koryak	Koryak
kpz	Kupsabiny	Kupsabiny
kqa	Mum	Mum
kqb	Kovai	Kovai
kqc	Doromu	Doromu
kqd	Koy Sanjaq Surat	Koy Sanjaq Surat
kqe	Kalagan	Kalagan
kqf	Kakabai	Kakabai
kqg	Khe	Khe
kqh	Kisankasa	Kisankasa
kqi	Koitabu	Koitabu
kqj	Koromira	Koromira
kqk	Kotafon Gbe	Gbe, Kotafon
kql	Kyenele	Kyenele
kqm	Khisa	Khisa
kqn	Kaonde	Kaonde
kqo	Eastern Krahn	Krahn, Eastern
kqp	Kimré	Kimré
kqq	Krenak	Krenak
kqr	Kimaragang	Kimaragang
kqs	Northern Kissi	Kissi, Northern
kqt	Klias River Kadazan	Kadazan, Klias River
kqu	Seroa	Seroa
kqv	Okolod	Okolod
kqw	Kandas	Kandas
kqx	Mser	Mser
kqy	Koorete	Koorete
kqz	Korana	Korana
kra	Kumhali	Kumhali
krb	Karkin	Karkin
krc	Karachay-Balkar	Karachay-Balkar
krd	Kairui-Midiki	Kairui-Midiki
kre	Panará	Panará
krf	Koro (Vanuatu)	Koro (Vanuatu)
krg	North Korowai	Korowai, North
krh	Kurama	Kurama
kri	Krio	Krio
krj	Kinaray-A	Kinaray-A
krk	Kerek	Kerek
krl	Karelian	Karelian
krm	Krim	Krim
krn	Sapo	Sapo
krp	Korop	Korop
krq	Krui	Krui
krr	Kru'ng 2	Kru'ng 2
krs	Gbaya (Sudan)	Gbaya (Sudan)
krt	Tumari Kanuri	Kanuri, Tumari
kru	Kurukh	Kurukh
krv	Kavet	Kavet
krw	Western Krahn	Krahn, Western
krx	Karon	Karon
kry	Kryts	Kryts
krz	Sota Kanum	Kanum, Sota
ksa	Shuwa-Zamani	Shuwa-Zamani
ksb	Shambala	Shambala
ksc	Southern Kalinga	Kalinga, Southern
ksd	Kuanua	Kuanua
kse	Kuni	Kuni
ksf	Bafia	Bafia
ksg	Kusaghe	Kusaghe
ksh	Kölsch	Kölsch
ksi	Krisa	Krisa
ksj	Uare	Uare
ksk	Kansa	Kansa
ksl	Kumalu	Kumalu
ksm	Kumba	Kumba
ksn	Kasiguranin	Kasiguranin
kso	Kofa	Kofa
ksp	Kaba	Kaba
ksq	Kwaami	Kwaami
ksr	Borong	Borong
kss	Southern Kisi	Kisi, Southern
kst	Winyé	Winyé
ksu	Khamyang	Khamyang
ksv	Kusu	Kusu
ksw	S'gaw Karen	Karen, S'gaw
ksx	Kedang	Kedang
ksy	Kharia Thar	Kharia Thar
ksz	Koraku	Koraku
kta	Katua	Katua
ktb	Kambaata	Kambaata
ktc	Kholok	Kholok
ktd	Kokata	Kokata
kte	Nubri	Nubri
ktf	Kwami	Kwami
ktg	Kalkutung	Kalkutung
kth	Karanga	Karanga
kti	North Muyu	Muyu, North
ktj	Plapo Krumen	Krumen, Plapo
ktk	Kaniet	Kaniet
ktl	Koroshi	Koroshi
ktm	Kurti	Kurti
ktn	Karitiâna	Karitiâna
kto	Kuot	Kuot
ktp	Kaduo	Kaduo
ktq	Katabaga	Katabaga
ktr	Kota Marudu Tinagas	Kota Marudu Tinagas
kts	South Muyu	Muyu, South
ktt	Ketum	Ketum
ktu	Kituba (Democratic Republic of Congo)	Kituba (Democratic Republic of Congo)
ktv	Eastern Katu	Katu, Eastern
ktw	Kato	Kato
ktx	Kaxararí	Kaxararí
kty	Kango (Bas-Uélé District)	Kango (Bas-Uélé District)
ktz	Ju/'hoan	Ju/'hoan
kua	Kuanyama	Kuanyama
kua	Kwanyama	Kwanyama
kub	Kutep	Kutep
kud	'Auhelawa	'Auhelawa
kue	Kuman	Kuman
kuf	Western Katu	Katu, Western
kug	Kupa	Kupa
kuh	Kushi	Kushi
kui	Kuikúro-Kalapálo	Kuikúro-Kalapálo
kuj	Kuria	Kuria
kuk	Kepo'	Kepo'
kul	Kulere	Kulere
kum	Kumyk	Kumyk
kun	Kunama	Kunama
kuo	Kumukio	Kumukio
kup	Kunimaipa	Kunimaipa
kuq	Karipuna	Karipuna
kur	Kurdish	Kurdish
kus	Kusaal	Kusaal
kut	Kutenai	Kutenai
kuu	Upper Kuskokwim	Kuskokwim, Upper
kuv	Kur	Kur
kuw	Kpagua	Kpagua
kux	Kukatja	Kukatja
kuy	Kuuku-Ya'u	Kuuku-Ya'u
kuz	Kunza	Kunza
kva	Bagvalal	Bagvalal
kvb	Kubu	Kubu
kvc	Kove	Kove
kvd	Kui (Indonesia)	Kui (Indonesia)
kve	Kalabakan	Kalabakan
kvf	Kabalai	Kabalai
kvg	Kuni-Boazi	Kuni-Boazi
kvh	Komodo	Komodo
kvi	Kwang	Kwang
kvj	Psikye	Psikye
kvk	Korean Sign Language	Korean Sign Language
kvl	Brek Karen	Karen, Brek
kvm	Kendem	Kendem
kvn	Border Kuna	Kuna, Border
kvo	Dobel	Dobel
kvp	Kompane	Kompane
kvq	Geba Karen	Karen, Geba
kvr	Kerinci	Kerinci
kvs	Kunggara	Kunggara
kvt	Lahta Karen	Karen, Lahta
kvu	Yinbaw Karen	Karen, Yinbaw
kvv	Kola	Kola
kvw	Wersing	Wersing
kvx	Parkari Koli	Koli, Parkari
kvy	Yintale Karen	Karen, Yintale
kvz	Tsakwambo	Tsakwambo
kwa	Dâw	Dâw
kwb	Kwa	Kwa
kwc	Likwala	Likwala
kwd	Kwaio	Kwaio
kwe	Kwerba	Kwerba
kwf	Kwara'ae	Kwara'ae
kwg	Kaba Deme	Kaba Deme
kwh	Kowiai	Kowiai
kwi	Awa-Cuaiquer	Awa-Cuaiquer
kwj	Kwanga	Kwanga
kwk	Kwakiutl	Kwakiutl
kwl	Kofyar	Kofyar
kwm	Kwambi	Kwambi
kwn	Kwangali	Kwangali
kwo	Kwomtari	Kwomtari
kwp	Kodia	Kodia
kwq	Kwak	Kwak
kwr	Kwer	Kwer
kws	Kwese	Kwese
kwt	Kwesten	Kwesten
kwu	Kwakum	Kwakum
kwv	Kaba Na	Kaba Na
kww	Kwinti	Kwinti
kwx	Khirwar	Khirwar
kwy	San Salvador Kongo	Kongo, San Salvador
kwz	Kwadi	Kwadi
kxa	Kairiru	Kairiru
kxb	Krobu	Krobu
kxc	Komso	Komso
kxd	Brunei	Brunei
kxe	Kakihum	Kakihum
kxf	Manumanaw Karen	Karen, Manumanaw
kxg	Katingan	Katingan
kxh	Karo (Ethiopia)	Karo (Ethiopia)
kxi	Keningau Murut	Murut, Keningau
kxj	Kulfa	Kulfa
kxk	Zayein Karen	Karen, Zayein
kxl	Nepali Kurux	Kurux, Nepali
kxm	Northern Khmer	Khmer, Northern
kxn	Kanowit	Kanowit
kxo	Kanoé	Kanoé
kxp	Wadiyara Koli	Koli, Wadiyara
kxq	Smärky Kanum	Kanum, Smärky
kxr	Koro (Papua New Guinea)	Koro (Papua New Guinea)
kxs	Kangjia	Kangjia
kxt	Koiwat	Koiwat
kxu	Kui (India)	Kui (India)
kxv	Kuvi	Kuvi
kxw	Konai	Konai
kxx	Likuba	Likuba
kxy	Kayong	Kayong
kxz	Kerewo	Kerewo
kya	Kwaya	Kwaya
kyb	Butbut Kalinga	Kalinga, Butbut
kyc	Kyaka	Kyaka
kyd	Karey	Karey
kye	Krache	Krache
kyf	Kouya	Kouya
kyg	Keyagana	Keyagana
kyh	Karok	Karok
kyi	Kiput	Kiput
kyj	Karao	Karao
kyk	Kamayo	Kamayo
kyl	Kalapuya	Kalapuya
kym	Kpatili	Kpatili
kyn	Karolanos	Karolanos
kyo	Kelon	Kelon
kyp	Kang	Kang
kyq	Kenga	Kenga
kyr	Kuruáya	Kuruáya
kys	Baram Kayan	Kayan, Baram
kyt	Kayagar	Kayagar
kyu	Western Kayah	Kayah, Western
kyv	Kayort	Kayort
kyw	Kudmali	Kudmali
kyx	Rapoisi	Rapoisi
kyy	Kambaira	Kambaira
kyz	Kayabí	Kayabí
kza	Western Karaboro	Karaboro, Western
kzb	Kaibobo	Kaibobo
kzc	Bondoukou Kulango	Kulango, Bondoukou
kzd	Kadai	Kadai
kze	Kosena	Kosena
kzf	Da'a Kaili	Kaili, Da'a
kzg	Kikai	Kikai
kzh	Kenuzi-Dongola	Kenuzi-Dongola
kzi	Kelabit	Kelabit
kzj	Coastal Kadazan	Kadazan, Coastal
kzk	Kazukuru	Kazukuru
kzl	Kayeli	Kayeli
kzm	Kais	Kais
kzn	Kokola	Kokola
kzo	Kaningi	Kaningi
kzp	Kaidipang	Kaidipang
kzq	Kaike	Kaike
kzr	Karang	Karang
kzs	Sugut Dusun	Dusun, Sugut
kzt	Tambunan Dusun	Dusun, Tambunan
kzu	Kayupulau	Kayupulau
kzv	Komyandaret	Komyandaret
kzw	Karirí-Xocó	Karirí-Xocó
kzx	Kamarian	Kamarian
kzy	Kango (Tshopo District)	Kango (Tshopo District)
kzz	Kalabra	Kalabra
laa	Lapuyan Subanun	Subanun, Lapuyan
lab	Linear A	Linear A
lac	Lacandon	Lacandon
lad	Ladino	Ladino
lae	Pattani	Pattani
laf	Lafofa	Lafofa
lag	Langi	Langi
lah	Lahnda	Lahnda
lai	Lambya	Lambya
laj	Lango (Uganda)	Lango (Uganda)
lak	Laka (Nigeria)	Laka (Nigeria)
lal	Lalia	Lalia
lam	Lamba	Lamba
lan	Laru	Laru
lao	Lao	Lao
lap	Laka (Chad)	Laka (Chad)
laq	Qabiao	Qabiao
lar	Larteh	Larteh
las	Lama (Togo)	Lama (Togo)
lat	Latin	Latin
lau	Laba	Laba
lav	Latvian	Latvian
law	Lauje	Lauje
lax	Tiwa	Tiwa
lay	Lama (Myanmar)	Lama (Myanmar)
laz	Aribwatsa	Aribwatsa
lba	Lui	Lui
lbb	Label	Label
lbc	Lakkia	Lakkia
lbe	Lak	Lak
lbf	Tinani	Tinani
lbg	Laopang	Laopang
lbi	La'bi	La'bi
lbj	Ladakhi	Ladakhi
lbm	Lodhi	Lodhi
lbn	Lamet	Lamet
lbo	Laven	Laven
lbq	Wampar	Wampar
lbr	Northern Lorung	Lorung, Northern
lbs	Libyan Sign Language	Libyan Sign Language
lbt	Lachi	Lachi
lbu	Labu	Labu
lbv	Lavatbura-Lamusong	Lavatbura-Lamusong
lbw	Tolaki	Tolaki
lbx	Lawangan	Lawangan
lby	Lamu-Lamu	Lamu-Lamu
lbz	Lardil	Lardil
lcc	Legenyem	Legenyem
lcd	Lola	Lola
lce	Loncong	Loncong
lcf	Lubu	Lubu
lch	Luchazi	Luchazi
lcl	Lisela	Lisela
lcm	Tungag	Tungag
lcp	Western Lawa	Lawa, Western
lcq	Luhu	Luhu
lcs	Lisabata-Nuniali	Lisabata-Nuniali
ldb	Idun	Idun
ldd	Luri	Luri
ldg	Lenyima	Lenyima
ldh	Lamja-Dengsa-Tola	Lamja-Dengsa-Tola
ldi	Laari	Laari
ldj	Lemoro	Lemoro
ldk	Leelau	Leelau
ldl	Kaan	Kaan
ldm	Landoma	Landoma
ldn	Láadan	Láadan
ldo	Loo	Loo
ldp	Tso	Tso
ldq	Lufu	Lufu
lea	Lega-Shabunda	Lega-Shabunda
leb	Lala-Bisa	Lala-Bisa
lec	Leco	Leco
led	Lendu	Lendu
lee	Lyélé	Lyélé
lef	Lelemi	Lelemi
leg	Lengua	Lengua
leh	Lenje	Lenje
lei	Lemio	Lemio
lej	Lengola	Lengola
lek	Leipon	Leipon
lel	Lele (Democratic Republic of Congo)	Lele (Democratic Republic of Congo)
lem	Nomaande	Nomaande
len	Lenca	Lenca
leo	Leti (Cameroon)	Leti (Cameroon)
lep	Lepcha	Lepcha
leq	Lembena	Lembena
ler	Lenkau	Lenkau
les	Lese	Lese
let	Lesing-Gelimi	Lesing-Gelimi
leu	Kara (Papua New Guinea)	Kara (Papua New Guinea)
lev	Lamma	Lamma
lew	Ledo Kaili	Kaili, Ledo
lex	Luang	Luang
ley	Lemolang	Lemolang
lez	Lezghian	Lezghian
lfa	Lefa	Lefa
lga	Lungga	Lungga
lgb	Laghu	Laghu
lgg	Lugbara	Lugbara
lgh	Laghuu	Laghuu
lgi	Lengilu	Lengilu
lgk	Lingarak	Lingarak
lgl	Wala	Wala
lgm	Lega-Mwenga	Lega-Mwenga
lgn	Opuuo	Opuuo
lgq	Logba	Logba
lgr	Lengo	Lengo
lgt	Pahi	Pahi
lgu	Longgu	Longgu
lgz	Ligenza	Ligenza
lha	Laha (Viet Nam)	Laha (Viet Nam)
lhh	Laha (Indonesia)	Laha (Indonesia)
lhl	Lahul Lohar	Lohar, Lahul
lhm	Lhomi	Lhomi
lhn	Lahanan	Lahanan
lhp	Lhokpu	Lhokpu
lhs	Mlahsö	Mlahsö
lht	Toga	Toga
lhu	Lahu	Lahu
lia	West-Central Limba	Limba, West-Central
lib	Likum	Likum
lic	Hlai	Hlai
lid	Nyindrou	Nyindrou
lie	Likila	Likila
lif	Limbu	Limbu
lig	Ligbi	Ligbi
lih	Lihir	Lihir
lii	Lingkhim	Lingkhim
lij	Ligurian	Ligurian
lik	Lika	Lika
lil	Lillooet	Lillooet
lim	Limburgan	Limburgan
lim	Limburger	Limburger
lim	Limburgish	Limburgish
lin	Lingala	Lingala
lio	Liki	Liki
lip	Sekpele	Sekpele
liq	Libido	Libido
lir	Liberian English	English, Liberian
lis	Lisu	Lisu
lit	Lithuanian	Lithuanian
liu	Logorik	Logorik
liv	Liv	Liv
liw	Lembak	Lembak
lix	Liabuku	Liabuku
liy	Banda-Bambari	Banda-Bambari
liz	Libinza	Libinza
lje	Rampi	Rampi
lji	Laiyolo	Laiyolo
ljl	Li'o	Li'o
ljp	Lampung	Lampung
lka	Lakalei	Lakalei
lke	Kenyi	Kenyi
lkh	Lakha	Lakha
lki	Laki	Laki
lkj	Remun	Remun
lkl	Laeko-Libuat	Laeko-Libuat
lkn	Lakona	Lakona
lkr	Päri	Päri
lkt	Lakota	Lakota
lky	Lokoya	Lokoya
lla	Lala-Roba	Lala-Roba
llb	Lolo	Lolo
llc	Lele (Guinea)	Lele (Guinea)
lld	Ladin	Ladin
lle	Lele (Papua New Guinea)	Lele (Papua New Guinea)
llf	Hermit	Hermit
llg	Lole	Lole
lli	Teke-Laali	Teke-Laali
llk	Lelak	Lelak
lll	Lilau	Lilau
llm	Lasalimu	Lasalimu
lln	Lele (Chad)	Lele (Chad)
llo	Khlor	Khlor
llp	North Efate	Efate, North
llq	Lolak	Lolak
lls	Lithuanian Sign Language	Lithuanian Sign Language
llu	Lau	Lau
llx	Lauan	Lauan
lma	East Limba	Limba, East
lmb	Merei	Merei
lmc	Limilngan	Limilngan
lmd	Lumun	Lumun
lme	Pévé	Pévé
lmf	South Lembata	Lembata, South
lmg	Lamogai	Lamogai
lmh	Lambichhong	Lambichhong
lmi	Lombi	Lombi
lmj	West Lembata	Lembata, West
lmk	Lamkang	Lamkang
lml	Hano	Hano
lmm	Lamam	Lamam
lmn	Lambadi	Lambadi
lmo	Lombard	Lombard
lmp	Limbum	Limbum
lmq	Lamatuka	Lamatuka
lmr	Lamalera	Lamalera
lmt	Lematang	Lematang
lmu	Lamenu	Lamenu
lmv	Lomaiviti	Lomaiviti
lmw	Lake Miwok	Miwok, Lake
lmx	Laimbue	Laimbue
lmy	Lamboya	Lamboya
lmz	Lumbee	Lumbee
lna	Langbashe	Langbashe
lnb	Mbalanhu	Mbalanhu
lnd	Lundayeh	Lundayeh
lng	Langobardic	Langobardic
lnh	Lanoh	Lanoh
lni	Lantanai	Lantanai
lnj	Leningitij	Leningitij
lnl	South Central Banda	Banda, South Central
lnm	Langam	Langam
lnn	Lorediakarkar	Lorediakarkar
lno	Lango (Sudan)	Lango (Sudan)
lns	Lamnso'	Lamnso'
lnt	Lintang	Lintang
lnu	Longuda	Longuda
lnz	Lonzo	Lonzo
loa	Loloda	Loloda
lob	Lobi	Lobi
loc	Inonhan	Inonhan
lod	Berawan	Berawan
loe	Coastal Saluan	Saluan, Coastal
lof	Logol	Logol
log	Logo	Logo
loh	Narim	Narim
loi	Loma (Côte d'Ivoire)	Loma (Côte d'Ivoire)
loj	Lou	Lou
lok	Loko	Loko
lol	Mongo	Mongo
lom	Loma (Liberia)	Loma (Liberia)
lon	Malawi Lomwe	Lomwe, Malawi
loo	Lombo	Lombo
lop	Lopa	Lopa
loq	Lobala	Lobala
lor	Téén	Téén
los	Loniu	Loniu
lot	Otuho	Otuho
lou	Louisiana Creole French	Creole French, Louisiana
lov	Lopi	Lopi
low	Tampias Lobu	Lobu, Tampias
lox	Loun	Loun
loy	Lowa	Lowa
loz	Lozi	Lozi
lpa	Lelepa	Lelepa
lpe	Lepki	Lepki
lpo	Lipo	Lipo
lpx	Lopit	Lopit
lra	Lara'	Lara'
lrc	Northern Luri	Luri, Northern
lre	Laurentian	Laurentian
lrg	Laragia	Laragia
lrk	Loarki	Loarki
lrl	Lari	Lari
lrn	Lorang	Lorang
lro	Laro	Laro
lrr	Southern Lorung	Lorung, Southern
lrv	Larevat	Larevat
lsa	Lasgerdi	Lasgerdi
lsd	Lishana Deni	Lishana Deni
lse	Lusengo	Lusengo
lsg	Lyons Sign Language	Lyons Sign Language
lsh	Lish	Lish
lsi	Lashi	Lashi
lsl	Latvian Sign Language	Latvian Sign Language
lso	Laos Sign Language	Laos Sign Language
lsr	Aruop	Aruop
lss	Lasi	Lasi
ltc	Late Middle Chinese	Chinese, Late Middle
lti	Leti (Indonesia)	Leti (Indonesia)
ltu	Latu	Latu
ltz	Letzeburgesch	Letzeburgesch
ltz	Luxembourgish	Luxembourgish
lua	Luba-Lulua	Luba-Lulua
lub	Luba-Katanga	Luba-Katanga
luc	Aringa	Aringa
lud	Ludian	Ludian
lue	Luvale	Luvale
luf	Laua	Laua
lug	Ganda	Ganda
lui	Luiseno	Luiseno
luj	Luna	Luna
luk	Lunanakha	Lunanakha
lul	Olu'bo	Olu'bo
lum	Luimbi	Luimbi
lun	Lunda	Lunda
luo	Luo (Kenya and Tanzania)	Luo (Kenya and Tanzania)
lup	Lumbu	Lumbu
luq	Lucumi	Lucumi
lur	Laura	Laura
lus	Lushai	Lushai
lut	Lushootseed	Lushootseed
luu	Lumba-Yakkha	Lumba-Yakkha
luv	Luwati	Luwati
luw	Luo	Luo
luy	Luyia	Luyia
luz	Southern Luri	Luri, Southern
lva	Maku'a	Maku'a
lvk	Lavukaleve	Lavukaleve
lvu	Levuka	Levuka
lwa	Lwalu	Lwalu
lwe	Lewo Eleng	Lewo Eleng
lwh	White Lachi	Lachi, White
lwl	Eastern Lawa	Lawa, Eastern
lwo	Luwo	Luwo
lwt	Lewotobi	Lewotobi
lww	Lewo	Lewo
lya	Layakha	Layakha
lyn	Luyana	Luyana
lzl	Litzlitz	Litzlitz
lzz	Laz	Laz
maa	San Jerónimo Tecóatl Mazatec	Mazatec, San Jerónimo Tecóatl
mab	Yutanduchi Mixtec	Mixtec, Yutanduchi
mad	Madurese	Madurese
mae	Bo-Rukul	Bo-Rukul
maf	Mafa	Mafa
mag	Magahi	Magahi
mah	Marshallese	Marshallese
mai	Maithili	Maithili
maj	Jalapa De Díaz Mazatec	Mazatec, Jalapa De Díaz
mak	Makasar	Makasar
mal	Malayalam	Malayalam
mam	Northern Mam	Mam, Northern
man	Mandingo	Mandingo
maq	Chiquihuitlán Mazatec	Mazatec, Chiquihuitlán
mar	Marathi	Marathi
mas	Masai	Masai
mat	San Francisco Matlatzinca	Matlatzinca, San Francisco
mau	Huautla Mazatec	Mazatec, Huautla
mav	Sateré-Mawé	Sateré-Mawé
maw	Mampruli	Mampruli
max	North Moluccan Malay	Malay, North Moluccan
maz	Central Mazahua	Mazahua, Central
mba	Higaonon	Higaonon
mbb	Western Bukidnon Manobo	Manobo, Western Bukidnon
mbc	Macushi	Macushi
mbd	Dibabawon Manobo	Manobo, Dibabawon
mbe	Molale	Molale
mbf	Baba Malay	Malay, Baba
mbg	Northern Nambikuára	Nambikuára, Northern
mbh	Mangseng	Mangseng
mbi	Ilianen Manobo	Manobo, Ilianen
mbj	Nadëb	Nadëb
mbk	Malol	Malol
mbl	Maxakalí	Maxakalí
mbm	Ombamba	Ombamba
mbn	Macaguán	Macaguán
mbo	Mbo (Cameroon)	Mbo (Cameroon)
mbp	Malayo	Malayo
mbq	Maisin	Maisin
mbr	Nukak Makú	Nukak Makú
mbs	Sarangani Manobo	Manobo, Sarangani
mbt	Matigsalug Manobo	Manobo, Matigsalug
mbu	Mbula-Bwazza	Mbula-Bwazza
mbv	Mbulungish	Mbulungish
mbw	Maring	Maring
mbx	Mari (East Sepik Province)	Mari (East Sepik Province)
mby	Memoni	Memoni
mbz	Amoltepec Mixtec	Mixtec, Amoltepec
mca	Maca	Maca
mcb	Machiguenga	Machiguenga
mcc	Bitur	Bitur
mcd	Sharanahua	Sharanahua
mce	Itundujia Mixtec	Mixtec, Itundujia
mcf	Matsés	Matsés
mcg	Mapoyo	Mapoyo
mch	Maquiritari	Maquiritari
mci	Mese	Mese
mcj	Mvanip	Mvanip
mck	Mbunda	Mbunda
mcl	Macaguaje	Macaguaje
mcm	Malaccan Creole Portuguese	Creole Portuguese, Malaccan
mcn	Masana	Masana
mco	Coatlán Mixe	Mixe, Coatlán
mcp	Makaa	Makaa
mcq	Ese	Ese
mcr	Menya	Menya
mcs	Mambai	Mambai
mct	Mengisa	Mengisa
mcu	Cameroon Mambila	Mambila, Cameroon
mcv	Minanibai	Minanibai
mcw	Mawa (Chad)	Mawa (Chad)
mcx	Mpiemo	Mpiemo
mcy	South Watut	Watut, South
mcz	Mawan	Mawan
mda	Mada (Nigeria)	Mada (Nigeria)
mdb	Morigi	Morigi
mdc	Male (Papua New Guinea)	Male (Papua New Guinea)
mdd	Mbum	Mbum
mde	Maba (Chad)	Maba (Chad)
mdf	Moksha	Moksha
mdg	Massalat	Massalat
mdh	Maguindanao	Maguindanao
mdi	Mamvu	Mamvu
mdj	Mangbetu	Mangbetu
mdk	Mangbutu	Mangbutu
mdl	Maltese Sign Language	Maltese Sign Language
mdm	Mayogo	Mayogo
mdn	Mbati	Mbati
mdo	Southwest Gbaya	Gbaya, Southwest
mdp	Mbala	Mbala
mdq	Mbole	Mbole
mdr	Mandar	Mandar
mds	Maria (Papua New Guinea)	Maria (Papua New Guinea)
mdt	Mbere	Mbere
mdu	Mboko	Mboko
mdv	Santa Lucía Monteverde Mixtec	Mixtec, Santa Lucía Monteverde
mdw	Mbosi	Mbosi
mdx	Dizi	Dizi
mdy	Male (Ethiopia)	Male (Ethiopia)
mdz	Suruí Do Pará	Suruí Do Pará
mea	Menka	Menka
meb	Ikobi-Mena	Ikobi-Mena
mec	Mara	Mara
med	Melpa	Melpa
mee	Mengen	Mengen
mef	Megam	Megam
meg	Mea	Mea
meh	Southwestern Tlaxiaco Mixtec	Mixtec, Southwestern Tlaxiaco
mei	Midob	Midob
mej	Meyah	Meyah
mek	Mekeo	Mekeo
mel	Melanau	Melanau
mem	Mangala	Mangala
men	Mende (Sierra Leone)	Mende (Sierra Leone)
meo	Kedah Malay	Malay, Kedah
mep	Miriwung	Miriwung
meq	Merey	Merey
mer	Meru	Meru
mes	Masmaje	Masmaje
met	Mato	Mato
meu	Motu	Motu
mev	Mann	Mann
mew	Maaka	Maaka
mey	Hassaniyya	Hassaniyya
mez	Menominee	Menominee
mfa	Pattani Malay	Malay, Pattani
mfb	Lom	Lom
mfc	Mba	Mba
mfd	Mendankwe-Nkwen	Mendankwe-Nkwen
mfe	Morisyen	Morisyen
mff	Naki	Naki
mfg	Mixifore	Mixifore
mfh	Matal	Matal
mfi	Wandala	Wandala
mfj	Mefele	Mefele
mfk	North Mofu	Mofu, North
mfl	Putai	Putai
mfm	Marghi South	Marghi South
mfn	Cross River Mbembe	Mbembe, Cross River
mfo	Mbe	Mbe
mfp	Makassar Malay	Malay, Makassar
mfq	Moba	Moba
mfr	Marithiel	Marithiel
mfs	Mexican Sign Language	Mexican Sign Language
mft	Mokerang	Mokerang
mfu	Mbwela	Mbwela
mfv	Mandjak	Mandjak
mfw	Mulaha	Mulaha
mfx	Melo	Melo
mfy	Mayo	Mayo
mfz	Mabaan	Mabaan
mga	Middle Irish (900-1200)	Irish, Middle (900-1200)
mgb	Mararit	Mararit
mgc	Morokodo	Morokodo
mgd	Moru	Moru
mge	Mango	Mango
mgf	Maklew	Maklew
mgg	Mpongmpong	Mpongmpong
mgh	Makhuwa-Meetto	Makhuwa-Meetto
mgi	Lijili	Lijili
mgj	Abureni	Abureni
mgk	Mawes	Mawes
mgl	Maleu-Kilenge	Maleu-Kilenge
mgm	Mambae	Mambae
mgn	Mbangi	Mbangi
mgo	Meta'	Meta'
mgp	Eastern Magar	Magar, Eastern
mgq	Malila	Malila
mgr	Mambwe-Lungu	Mambwe-Lungu
mgs	Manda (Tanzania)	Manda (Tanzania)
mgt	Mongol	Mongol
mgu	Mailu	Mailu
mgv	Matengo	Matengo
mgw	Matumbi	Matumbi
mgx	Omati	Omati
mgy	Mbunga	Mbunga
mgz	Mbugwe	Mbugwe
mha	Manda (India)	Manda (India)
mhb	Mahongwe	Mahongwe
mhc	Mocho	Mocho
mhd	Mbugu	Mbugu
mhe	Besisi	Besisi
mhf	Mamaa	Mamaa
mhg	Margu	Margu
mhh	Maskoy Pidgin	Maskoy Pidgin
mhi	Ma'di	Ma'di
mhj	Mogholi	Mogholi
mhk	Mungaka	Mungaka
mhl	Mauwake	Mauwake
mhm	Makhuwa-Moniga	Makhuwa-Moniga
mhn	Mócheno	Mócheno
mho	Mashi (Zambia)	Mashi (Zambia)
mhp	Balinese Malay	Malay, Balinese
mhq	Mandan	Mandan
mhr	Eastern Mari	Mari, Eastern
mhs	Buru (Indonesia)	Buru (Indonesia)
mht	Mandahuaca	Mandahuaca
mhu	Digaro-Mishmi	Digaro-Mishmi
mhv	Arakanese	Arakanese
mhw	Mbukushu	Mbukushu
mhx	Maru	Maru
mhy	Ma'anyan	Ma'anyan
mhz	Mor (Mor Islands)	Mor (Mor Islands)
mia	Miami	Miami
mib	Atatláhuca Mixtec	Mixtec, Atatláhuca
mic	Micmac	Micmac
mic	Mi'kmaq	Mi'kmaq
mid	Mandaic	Mandaic
mie	Ocotepec Mixtec	Mixtec, Ocotepec
mif	Mofu-Gudur	Mofu-Gudur
mig	San Miguel El Grande Mixtec	Mixtec, San Miguel El Grande
mih	Chayuco Mixtec	Mixtec, Chayuco
mii	Chigmecatitlán Mixtec	Mixtec, Chigmecatitlán
mij	Abar	Abar
mik	Mikasuki	Mikasuki
mil	Peñoles Mixtec	Mixtec, Peñoles
mim	Alacatlatzala Mixtec	Mixtec, Alacatlatzala
min	Minangkabau	Minangkabau
mio	Pinotepa Nacional Mixtec	Mixtec, Pinotepa Nacional
mip	Apasco-Apoala Mixtec	Mixtec, Apasco-Apoala
miq	Mískito	Mískito
mir	Isthmus Mixe	Mixe, Isthmus
mis	Uncoded languages	Uncoded languages
mit	Southern Puebla Mixtec	Mixtec, Southern Puebla
miu	Cacaloxtepec Mixtec	Mixtec, Cacaloxtepec
miv	Mimi	Mimi
miw	Akoye	Akoye
mix	Mixtepec Mixtec	Mixtec, Mixtepec
miy	Ayutla Mixtec	Mixtec, Ayutla
miz	Coatzospan Mixtec	Mixtec, Coatzospan
mja	Mahei	Mahei
mjc	San Juan Colorado Mixtec	Mixtec, San Juan Colorado
mjd	Northwest Maidu	Maidu, Northwest
mje	Muskum	Muskum
mjg	Tu	Tu
mjh	Mwera (Nyasa)	Mwera (Nyasa)
mji	Kim Mun	Kim Mun
mjj	Mawak	Mawak
mjk	Matukar	Matukar
mjl	Mandeali	Mandeali
mjm	Medebur	Medebur
mjn	Ma (Papua New Guinea)	Ma (Papua New Guinea)
mjo	Malankuravan	Malankuravan
mjp	Malapandaram	Malapandaram
mjq	Malaryan	Malaryan
mjr	Malavedan	Malavedan
mjs	Miship	Miship
mjt	Sauria Paharia	Sauria Paharia
mju	Manna-Dora	Manna-Dora
mjv	Mannan	Mannan
mjw	Karbi	Karbi
mjx	Mahali	Mahali
mjy	Mahican	Mahican
mjz	Majhi	Majhi
mka	Mbre	Mbre
mkb	Mal Paharia	Mal Paharia
mkc	Siliput	Siliput
mkd	Macedonian	Macedonian
mke	Mawchi	Mawchi
mkf	Miya	Miya
mkg	Mak (China)	Mak (China)
mki	Dhatki	Dhatki
mkj	Mokilese	Mokilese
mkk	Byep	Byep
mkl	Mokole	Mokole
mkm	Moklen	Moklen
mkn	Kupang Malay	Malay, Kupang
mko	Mingang Doso	Mingang Doso
mkp	Moikodi	Moikodi
mkq	Bay Miwok	Miwok, Bay
mkr	Malas	Malas
mks	Silacayoapan Mixtec	Mixtec, Silacayoapan
mkt	Vamale	Vamale
mku	Konyanka Maninka	Maninka, Konyanka
mkv	Mafea	Mafea
mkw	Kituba (Congo)	Kituba (Congo)
mkx	Cinamiguin Manobo	Manobo, Cinamiguin
mky	East Makian	Makian, East
mkz	Makasae	Makasae
mla	Malo	Malo
mlb	Mbule	Mbule
mlc	Cao Lan	Cao Lan
mld	Malakhel	Malakhel
mle	Manambu	Manambu
mlf	Mal	Mal
mlg	Malagasy	Malagasy
mlh	Mape	Mape
mli	Malimpung	Malimpung
mlj	Miltu	Miltu
mlk	Ilwana	Ilwana
mll	Malua Bay	Malua Bay
mlm	Mulam	Mulam
mln	Malango	Malango
mlo	Mlomp	Mlomp
mlp	Bargam	Bargam
mlq	Western Maninkakan	Maninkakan, Western
mlr	Vame	Vame
mls	Masalit	Masalit
mlt	Maltese	Maltese
mlu	To'abaita	To'abaita
mlv	Motlav	Motlav
mlw	Moloko	Moloko
mlx	Malfaxal	Malfaxal
mly	Malay (individual language)	Malay (individual language)
mlz	Malaynon	Malaynon
mma	Mama	Mama
mmb	Momina	Momina
mmc	Michoacán Mazahua	Mazahua, Michoacán
mmd	Maonan	Maonan
mme	Mae	Mae
mmf	Mundat	Mundat
mmg	North Ambrym	Ambrym, North
mmh	Mehináku	Mehináku
mmi	Musar	Musar
mmj	Majhwar	Majhwar
mmk	Mukha-Dora	Mukha-Dora
mml	Man Met	Man Met
mmm	Maii	Maii
mmn	Mamanwa	Mamanwa
mmo	Mangga Buang	Buang, Mangga
mmp	Musan	Musan
mmq	Musak	Musak
mmr	Western Xiangxi Hmong	Hmong, Western Xiangxi
mms	Southern Mam	Mam, Southern
mmt	Malalamai	Malalamai
mmu	Mmaala	Mmaala
mmv	Miriti	Miriti
mmw	Emae	Emae
mmx	Madak	Madak
mmy	Migaama	Migaama
mmz	Mabaale	Mabaale
mna	Mbula	Mbula
mnb	Muna	Muna
mnc	Manchu	Manchu
mnd	Mondé	Mondé
mne	Naba	Naba
mnf	Mundani	Mundani
mng	Eastern Mnong	Mnong, Eastern
mnh	Mono (Democratic Republic of Congo)	Mono (Democratic Republic of Congo)
mni	Manipuri	Manipuri
mnj	Munji	Munji
mnk	Mandinka	Mandinka
mnl	Tiale	Tiale
mnm	Mapena	Mapena
mnn	Southern Mnong	Mnong, Southern
mnp	Min Bei Chinese	Chinese, Min Bei
mnq	Minriq	Minriq
mnr	Mono (USA)	Mono (USA)
mns	Mansi	Mansi
mnt	Maykulan	Maykulan
mnu	Mer	Mer
mnv	Rennell-Belona	Rennell-Belona
mnw	Mon	Mon
mnx	Manikion	Manikion
mny	Manyawa	Manyawa
mnz	Moni	Moni
moa	Mwan	Mwan
moc	Mocoví	Mocoví
mod	Mobilian	Mobilian
moe	Montagnais	Montagnais
mof	Mohegan-Montauk-Narragansett	Mohegan-Montauk-Narragansett
mog	Mongondow	Mongondow
moh	Mohawk	Mohawk
moi	Mboi	Mboi
moj	Monzombo	Monzombo
mok	Morori	Morori
mol	Moldavian	Moldavian
mom	Monimbo	Monimbo
mon	Mongolian	Mongolian
moo	Monom	Monom
mop	Mopán Maya	Mopán Maya
moq	Mor (Bomberai Peninsula)	Mor (Bomberai Peninsula)
mor	Moro	Moro
mos	Mossi	Mossi
mot	Barí	Barí
mou	Mogum	Mogum
mov	Mohave	Mohave
mow	Moi (Congo)	Moi (Congo)
mox	Molima	Molima
moy	Shekkacho	Shekkacho
moz	Mukulu	Mukulu
mpa	Mpoto	Mpoto
mpb	Mullukmulluk	Mullukmulluk
mpc	Mangarayi	Mangarayi
mpd	Machinere	Machinere
mpe	Majang	Majang
mpf	Tajumulco Mam	Mam, Tajumulco
mpg	Marba	Marba
mph	Maung	Maung
mpi	Mpade	Mpade
mpj	Martu Wangka	Martu Wangka
mpk	Mbara (Chad)	Mbara (Chad)
mpl	Middle Watut	Watut, Middle
mpm	Yosondúa Mixtec	Mixtec, Yosondúa
mpn	Mindiri	Mindiri
mpo	Miu	Miu
mpp	Migabac	Migabac
mpq	Matís	Matís
mpr	Vangunu	Vangunu
mps	Dadibi	Dadibi
mpt	Mian	Mian
mpu	Makuráp	Makuráp
mpv	Mungkip	Mungkip
mpw	Mapidian	Mapidian
mpx	Misima-Paneati	Misima-Paneati
mpy	Mapia	Mapia
mpz	Mpi	Mpi
mqa	Maba (Indonesia)	Maba (Indonesia)
mqb	Mbuko	Mbuko
mqc	Mangole	Mangole
mqd	Madang	Madang
mqe	Matepi	Matepi
mqf	Momuna	Momuna
mqg	Kota Bangun Kutai Malay	Malay, Kota Bangun Kutai
mqh	Tlazoyaltepec Mixtec	Mixtec, Tlazoyaltepec
mqi	Mariri	Mariri
mqj	Mamasa	Mamasa
mqk	Rajah Kabunsuwan Manobo	Manobo, Rajah Kabunsuwan
mql	Mbelime	Mbelime
mqm	South Marquesan	Marquesan, South
mqn	Moronene	Moronene
mqo	Modole	Modole
mqp	Manipa	Manipa
mqq	Minokok	Minokok
mqr	Mander	Mander
mqs	West Makian	Makian, West
mqt	Mok	Mok
mqu	Mandari	Mandari
mqv	Mosimo	Mosimo
mqw	Murupi	Murupi
mqx	Mamuju	Mamuju
mqy	Manggarai	Manggarai
mqz	Malasanga	Malasanga
mra	Mlabri	Mlabri
mrb	Marino	Marino
mrc	Maricopa	Maricopa
mrd	Western Magar	Magar, Western
mre	Martha's Vineyard Sign Language	Martha's Vineyard Sign Language
mrf	Elseng	Elseng
mrg	Miri	Miri
mrh	Mara Chin	Chin, Mara
mri	Maori	Maori
mrj	Western Mari	Mari, Western
mrk	Hmwaveke	Hmwaveke
mrl	Mortlockese	Mortlockese
mrm	Merlav	Merlav
mrn	Cheke Holo	Cheke Holo
mro	Mru	Mru
mrp	Morouas	Morouas
mrq	North Marquesan	Marquesan, North
mrr	Maria (India)	Maria (India)
mrs	Maragus	Maragus
mrt	Marghi Central	Marghi Central
mru	Mono (Cameroon)	Mono (Cameroon)
mrv	Mangareva	Mangareva
mrw	Maranao	Maranao
mrx	Maremgi	Maremgi
mry	Karaga Mandaya	Mandaya, Karaga
mrz	Marind	Marind
msa	Malay (macrolanguage)	Malay (macrolanguage)
msb	Masbatenyo	Masbatenyo
msc	Sankaran Maninka	Maninka, Sankaran
msd	Yucatec Maya Sign Language	Yucatec Maya Sign Language
mse	Musey	Musey
msf	Mekwei	Mekwei
msg	Moraid	Moraid
msh	Masikoro Malagasy	Malagasy, Masikoro
msi	Sabah Malay	Malay, Sabah
msj	Ma (Democratic Republic of Congo)	Ma (Democratic Republic of Congo)
msk	Mansaka	Mansaka
msl	Molof	Molof
msm	Agusan Manobo	Manobo, Agusan
msn	Mosina	Mosina
mso	Mombum	Mombum
msp	Maritsauá	Maritsauá
msq	Caac	Caac
msr	Mongolian Sign Language	Mongolian Sign Language
mss	West Masela	Masela, West
mst	Cataelano Mandaya	Mandaya, Cataelano
msu	Musom	Musom
msv	Maslam	Maslam
msw	Mansoanka	Mansoanka
msx	Moresada	Moresada
msy	Aruamu	Aruamu
msz	Momare	Momare
mta	Cotabato Manobo	Manobo, Cotabato
mtb	Anyin Morofo	Anyin Morofo
mtc	Munit	Munit
mtd	Mualang	Mualang
mte	Mono (Solomon Islands)	Mono (Solomon Islands)
mtf	Murik	Murik
mtg	Una	Una
mth	Munggui	Munggui
mti	Maiwa (Papua New Guinea)	Maiwa (Papua New Guinea)
mtj	Moskona	Moskona
mtk	Mbe'	Mbe'
mtl	Montol	Montol
mtm	Mator	Mator
mtn	Matagalpa	Matagalpa
mto	Totontepec Mixe	Mixe, Totontepec
mtp	Wichí Lhamtés Nocten	Wichí Lhamtés Nocten
mtq	Muong	Muong
mtr	Mewari	Mewari
mts	Yora	Yora
mtt	Mota	Mota
mtu	Tututepec Mixtec	Mixtec, Tututepec
mtv	Asaro'o	Asaro'o
mtw	Magahat	Magahat
mtx	Tidaá Mixtec	Mixtec, Tidaá
mty	Nabi	Nabi
mtz	Tacanec	Tacanec
mua	Mundang	Mundang
mub	Mubi	Mubi
muc	Mbu'	Mbu'
mud	Mednyj Aleut	Aleut, Mednyj
mue	Media Lengua	Media Lengua
mug	Musgu	Musgu
muh	Mündü	Mündü
mui	Musi	Musi
muj	Mabire	Mabire
muk	Mugom	Mugom
mul	Multiple languages	Multiple languages
mum	Maiwala	Maiwala
muo	Nyong	Nyong
mup	Malvi	Malvi
muq	Eastern Xiangxi Hmong	Hmong, Eastern Xiangxi
mur	Murle	Murle
mus	Creek	Creek
mut	Western Muria	Muria, Western
muu	Yaaku	Yaaku
muv	Muthuvan	Muthuvan
muw	Mundari	Mundari
mux	Bo-Ung	Bo-Ung
muy	Muyang	Muyang
muz	Mursi	Mursi
mva	Manam	Manam
mvb	Mattole	Mattole
mvc	Central Mam	Mam, Central
mvd	Mamboru	Mamboru
mve	Marwari (Pakistan)	Marwari (Pakistan)
mvf	Peripheral Mongolian	Mongolian, Peripheral
mvg	Yucuañe Mixtec	Mixtec, Yucuañe
mvh	Mire	Mire
mvi	Miyako	Miyako
mvj	Todos Santos Cuchumatán Mam	Mam, Todos Santos Cuchumatán
mvk	Mekmek	Mekmek
mvl	Mbara (Australia)	Mbara (Australia)
mvm	Muya	Muya
mvn	Minaveha	Minaveha
mvo	Marovo	Marovo
mvp	Duri	Duri
mvq	Moere	Moere
mvr	Marau	Marau
mvs	Massep	Massep
mvt	Mpotovoro	Mpotovoro
mvu	Marfa	Marfa
mvv	Tagal Murut	Murut, Tagal
mvw	Machinga	Machinga
mvx	Meoswar	Meoswar
mvy	Indus Kohistani	Kohistani, Indus
mvz	Mesqan	Mesqan
mwa	Mwatebu	Mwatebu
mwb	Juwal	Juwal
mwc	Are	Are
mwd	Mudbura	Mudbura
mwe	Mwera (Chimwera)	Mwera (Chimwera)
mwf	Murrinh-Patha	Murrinh-Patha
mwg	Aiklep	Aiklep
mwh	Mouk-Aria	Mouk-Aria
mwi	Labo	Labo
mwj	Maligo	Maligo
mwk	Kita Maninkakan	Maninkakan, Kita
mwl	Mirandese	Mirandese
mwm	Sar	Sar
mwn	Nyamwanga	Nyamwanga
mwo	Central Maewo	Maewo, Central
mwp	Kala Lagaw Ya	Kala Lagaw Ya
mwq	Mün Chin	Chin, Mün
mwr	Marwari	Marwari
mws	Mwimbi-Muthambi	Mwimbi-Muthambi
mwt	Moken	Moken
mwu	Mittu	Mittu
mwv	Mentawai	Mentawai
mww	Hmong Daw	Hmong Daw
mwx	Mediak	Mediak
mwy	Mosiro	Mosiro
mwz	Moingi	Moingi
mxa	Northwest Oaxaca Mixtec	Mixtec, Northwest Oaxaca
mxb	Tezoatlán Mixtec	Mixtec, Tezoatlán
mxc	Manyika	Manyika
mxd	Modang	Modang
mxe	Mele-Fila	Mele-Fila
mxf	Malgbe	Malgbe
mxg	Mbangala	Mbangala
mxh	Mvuba	Mvuba
mxi	Mozarabic	Mozarabic
mxj	Miju-Mishmi	Miju-Mishmi
mxk	Monumbo	Monumbo
mxl	Maxi Gbe	Gbe, Maxi
mxm	Meramera	Meramera
mxn	Moi (Indonesia)	Moi (Indonesia)
mxo	Mbowe	Mbowe
mxp	Tlahuitoltepec Mixe	Mixe, Tlahuitoltepec
mxq	Juquila Mixe	Mixe, Juquila
mxr	Murik Kayan	Kayan, Murik
mxs	Huitepec Mixtec	Mixtec, Huitepec
mxt	Jamiltepec Mixtec	Mixtec, Jamiltepec
mxu	Mada (Cameroon)	Mada (Cameroon)
mxv	Metlatónoc Mixtec	Mixtec, Metlatónoc
mxw	Namo	Namo
mxx	Mahou	Mahou
mxy	Southeastern Nochixtlán Mixtec	Mixtec, Southeastern Nochixtlán
mxz	Central Masela	Masela, Central
mya	Burmese	Burmese
myb	Mbay	Mbay
myc	Mayeka	Mayeka
myd	Maramba	Maramba
mye	Myene	Myene
myf	Bambassi	Bambassi
myg	Manta	Manta
myh	Makah	Makah
myi	Mina (India)	Mina (India)
myj	Mangayat	Mangayat
myk	Mamara Senoufo	Senoufo, Mamara
myl	Moma	Moma
mym	Me'en	Me'en
myo	Anfillo	Anfillo
myp	Pirahã	Pirahã
myq	Forest Maninka	Maninka, Forest
myr	Muniche	Muniche
mys	Mesmes	Mesmes
myt	Sangab Mandaya	Mandaya, Sangab
myu	Mundurukú	Mundurukú
myv	Erzya	Erzya
myw	Muyuw	Muyuw
myx	Masaba	Masaba
myy	Macuna	Macuna
myz	Classical Mandaic	Mandaic, Classical
mza	Santa María Zacatepec Mixtec	Mixtec, Santa María Zacatepec
mzb	Tumzabt	Tumzabt
mzc	Madagascar Sign Language	Madagascar Sign Language
mzd	Malimba	Malimba
mze	Morawa	Morawa
mzg	Monastic Sign Language	Monastic Sign Language
mzh	Wichí Lhamtés Güisnay	Wichí Lhamtés Güisnay
mzi	Ixcatlán Mazatec	Mazatec, Ixcatlán
mzj	Manya	Manya
mzk	Nigeria Mambila	Mambila, Nigeria
mzl	Mazatlán Mixe	Mixe, Mazatlán
mzm	Mumuye	Mumuye
mzn	Mazanderani	Mazanderani
mzo	Matipuhy	Matipuhy
mzp	Movima	Movima
mzq	Mori Atas	Mori Atas
mzr	Marúbo	Marúbo
mzs	Macanese	Macanese
mzt	Mintil	Mintil
mzu	Inapang	Inapang
mzv	Manza	Manza
mzw	Deg	Deg
mzx	Mawayana	Mawayana
mzy	Mozambican Sign Language	Mozambican Sign Language
mzz	Maiadomu	Maiadomu
naa	Namla	Namla
nab	Southern Nambikuára	Nambikuára, Southern
nac	Narak	Narak
nad	Nijadali	Nijadali
nae	Naka'ela	Naka'ela
naf	Nabak	Nabak
nag	Naga Pidgin	Naga Pidgin
naj	Nalu	Nalu
nak	Nakanai	Nakanai
nal	Nalik	Nalik
nam	Nangikurrunggurr	Nangikurrunggurr
nan	Min Nan Chinese	Chinese, Min Nan
nao	Naaba	Naaba
nap	Neapolitan	Neapolitan
naq	Nama (Namibia)	Nama (Namibia)
nar	Iguta	Iguta
nas	Naasioi	Naasioi
nat	Hungworo	Hungworo
nau	Nauru	Nauru
nav	Navaho	Navaho
nav	Navajo	Navajo
naw	Nawuri	Nawuri
nax	Nakwi	Nakwi
nay	Narrinyeri	Narrinyeri
naz	Coatepec Nahuatl	Nahuatl, Coatepec
nba	Nyemba	Nyemba
nbb	Ndoe	Ndoe
nbc	Chang Naga	Naga, Chang
nbd	Ngbinda	Ngbinda
nbe	Konyak Naga	Naga, Konyak
nbf	Naxi	Naxi
nbg	Nagarchal	Nagarchal
nbh	Ngamo	Ngamo
nbi	Mao Naga	Naga, Mao
nbj	Ngarinman	Ngarinman
nbk	Nake	Nake
nbl	South Ndebele	Ndebele, South
nbm	Ngbaka Ma'bo	Ngbaka Ma'bo
nbn	Kuri	Kuri
nbo	Nkukoli	Nkukoli
nbp	Nnam	Nnam
nbq	Nggem	Nggem
nbr	Numana-Nunku-Gbantu-Numbu	Numana-Nunku-Gbantu-Numbu
nbs	Namibian Sign Language	Namibian Sign Language
nbt	Na	Na
nbu	Rongmei Naga	Naga, Rongmei
nbv	Ngamambo	Ngamambo
nbw	Southern Ngbandi	Ngbandi, Southern
nbx	Ngura	Ngura
nby	Ningera	Ningera
nca	Iyo	Iyo
ncb	Central Nicobarese	Nicobarese, Central
ncc	Ponam	Ponam
ncd	Nachering	Nachering
nce	Yale	Yale
ncf	Notsi	Notsi
ncg	Nisga'a	Nisga'a
nch	Central Huasteca Nahuatl	Nahuatl, Central Huasteca
nci	Classical Nahuatl	Nahuatl, Classical
ncj	Northern Puebla Nahuatl	Nahuatl, Northern Puebla
nck	Nakara	Nakara
ncl	Michoacán Nahuatl	Nahuatl, Michoacán
ncm	Nambo	Nambo
ncn	Nauna	Nauna
nco	Sibe	Sibe
ncp	Ndaktup	Ndaktup
ncr	Ncane	Ncane
ncs	Nicaraguan Sign Language	Nicaraguan Sign Language
nct	Chothe Naga	Naga, Chothe
ncu	Chumburung	Chumburung
ncx	Central Puebla Nahuatl	Nahuatl, Central Puebla
ncz	Natchez	Natchez
nda	Ndasa	Ndasa
ndb	Kenswei Nsei	Kenswei Nsei
ndc	Ndau	Ndau
ndd	Nde-Nsele-Nta	Nde-Nsele-Nta
nde	North Ndebele	Ndebele, North
ndf	Nadruvian	Nadruvian
ndg	Ndengereko	Ndengereko
ndh	Ndali	Ndali
ndi	Samba Leko	Samba Leko
ndj	Ndamba	Ndamba
ndk	Ndaka	Ndaka
ndl	Ndolo	Ndolo
ndm	Ndam	Ndam
ndn	Ngundi	Ngundi
ndo	Ndonga	Ndonga
ndp	Ndo	Ndo
ndq	Ndombe	Ndombe
ndr	Ndoola	Ndoola
nds	Low German	German, Low
nds	Low Saxon	Saxon, Low
ndt	Ndunga	Ndunga
ndu	Dugun	Dugun
ndv	Ndut	Ndut
ndw	Ndobo	Ndobo
ndx	Nduga	Nduga
ndy	Lutos	Lutos
ndz	Ndogo	Ndogo
nea	Eastern Ngad'a	Ngad'a, Eastern
neb	Toura (Côte d'Ivoire)	Toura (Côte d'Ivoire)
nec	Nedebang	Nedebang
ned	Nde-Gbite	Nde-Gbite
nee	Kumak	Kumak
nef	Nefamese	Nefamese
neg	Negidal	Negidal
neh	Nyenkha	Nyenkha
nei	Neo-Hittite	Hittite, Neo-
nej	Neko	Neko
nek	Neku	Neku
nem	Nemi	Nemi
nen	Nengone	Nengone
neo	Ná-Meo	Ná-Meo
nep	Nepali	Nepali
neq	North Central Mixe	Mixe, North Central
ner	Yahadian	Yahadian
nes	Bhoti Kinnauri	Kinnauri, Bhoti
net	Nete	Nete
nev	Nyaheun	Nyaheun
new	Nepal Bhasa	Bhasa, Nepal
new	Newari	Newari
nex	Neme	Neme
ney	Neyo	Neyo
nez	Nez Perce	Nez Perce
nfa	Dhao	Dhao
nfd	Ndun	Ndun
nfg	Nyeng	Nyeng
nfk	Shakara	Shakara
nfl	Ayiwo	Ayiwo
nfr	Nafaanra	Nafaanra
nfu	Mfumte	Mfumte
nga	Ngbaka	Ngbaka
ngb	Northern Ngbandi	Ngbandi, Northern
ngc	Ngombe (Democratic Republic of Congo)	Ngombe (Democratic Republic of Congo)
ngd	Ngando (Central African Republic)	Ngando (Central African Republic)
nge	Ngemba	Ngemba
ngg	Ngbaka Manza	Ngbaka Manza
ngh	N/u	N/u
ngi	Ngizim	Ngizim
ngj	Ngie	Ngie
ngk	Ngalkbun	Ngalkbun
ngl	Lomwe	Lomwe
ngm	Ngatik Men's Creole	Ngatik Men's Creole
ngn	Ngwo	Ngwo
ngo	Ngoni	Ngoni
ngp	Ngulu	Ngulu
ngq	Ngurimi	Ngurimi
ngr	Nanggu	Nanggu
ngs	Gvoko	Gvoko
ngt	Ngeq	Ngeq
ngu	Guerrero Nahuatl	Nahuatl, Guerrero
ngv	Nagumi	Nagumi
ngw	Ngwaba	Ngwaba
ngx	Nggwahyi	Nggwahyi
ngy	Tibea	Tibea
ngz	Ngungwel	Ngungwel
nha	Nhanda	Nhanda
nhb	Beng	Beng
nhc	Tabasco Nahuatl	Nahuatl, Tabasco
nhd	Chiripá	Chiripá
nhe	Eastern Huasteca Nahuatl	Nahuatl, Eastern Huasteca
nhf	Nhuwala	Nhuwala
nhg	Tetelcingo Nahuatl	Nahuatl, Tetelcingo
nhh	Nahari	Nahari
nhi	Zacatlán-Ahuacatlán-Tepetzintla Nahuatl	Nahuatl, Zacatlán-Ahuacatlán-Tepetzintla
nhk	Isthmus-Cosoleacaque Nahuatl	Nahuatl, Isthmus-Cosoleacaque
nhm	Morelos Nahuatl	Nahuatl, Morelos
nhn	Central Nahuatl	Nahuatl, Central
nho	Takuu	Takuu
nhp	Isthmus-Pajapan Nahuatl	Nahuatl, Isthmus-Pajapan
nhq	Huaxcaleca Nahuatl	Nahuatl, Huaxcaleca
nhr	Naro	Naro
nht	Ometepec Nahuatl	Nahuatl, Ometepec
nhu	Noone	Noone
nhv	Temascaltepec Nahuatl	Nahuatl, Temascaltepec
nhw	Western Huasteca Nahuatl	Nahuatl, Western Huasteca
nhx	Isthmus-Mecayapan Nahuatl	Nahuatl, Isthmus-Mecayapan
nhy	Northern Oaxaca Nahuatl	Nahuatl, Northern Oaxaca
nhz	Santa María La Alta Nahuatl	Nahuatl, Santa María La Alta
nia	Nias	Nias
nib	Nakama	Nakama
nid	Ngandi	Ngandi
nie	Niellim	Niellim
nif	Nek	Nek
nig	Ngalakan	Ngalakan
nih	Nyiha	Nyiha
nii	Nii	Nii
nij	Ngaju	Ngaju
nik	Southern Nicobarese	Nicobarese, Southern
nil	Nila	Nila
nim	Nilamba	Nilamba
nin	Ninzo	Ninzo
nio	Nganasan	Nganasan
nir	Nimboran	Nimboran
nis	Nimi	Nimi
nit	Southeastern Kolami	Kolami, Southeastern
niu	Niuean	Niuean
niv	Gilyak	Gilyak
niw	Nimo	Nimo
nix	Hema	Hema
niy	Ngiti	Ngiti
niz	Ningil	Ningil
nja	Nzanyi	Nzanyi
njb	Nocte Naga	Naga, Nocte
njd	Ndonde Hamba	Ndonde Hamba
njh	Lotha Naga	Naga, Lotha
nji	Gudanji	Gudanji
njj	Njen	Njen
njl	Njalgulgule	Njalgulgule
njm	Angami Naga	Naga, Angami
njn	Liangmai Naga	Naga, Liangmai
njo	Ao Naga	Naga, Ao
njr	Njerep	Njerep
njs	Nisa	Nisa
njt	Ndyuka-Trio Pidgin	Ndyuka-Trio Pidgin
nju	Ngadjunmaya	Ngadjunmaya
njx	Kunyi	Kunyi
njy	Njyem	Njyem
nka	Nkoya	Nkoya
nkb	Khoibu Naga	Naga, Khoibu
nkc	Nkongho	Nkongho
nkd	Koireng	Koireng
nke	Duke	Duke
nkf	Inpui Naga	Naga, Inpui
nkg	Nekgini	Nekgini
nkh	Khezha Naga	Naga, Khezha
nki	Thangal Naga	Naga, Thangal
nkj	Nakai	Nakai
nkk	Nokuku	Nokuku
nkm	Namat	Namat
nkn	Nkangala	Nkangala
nko	Nkonya	Nkonya
nkp	Niuatoputapu	Niuatoputapu
nkr	Nukuoro	Nukuoro
nks	North Asmat	Asmat, North
nku	Bouna Kulango	Kulango, Bouna
nkw	Nkutu	Nkutu
nkx	Nkoroo	Nkoroo
nky	Khiamniungan Naga	Naga, Khiamniungan
nkz	Nkari	Nkari
nla	Ngombale	Ngombale
nlc	Nalca	Nalca
nld	Dutch	Dutch
nld	Flemish	Flemish
nle	East Nyala	Nyala, East
nlg	Gela	Gela
nli	Grangali	Grangali
nlj	Nyali	Nyali
nlk	Ninia Yali	Yali, Ninia
nll	Nihali	Nihali
nln	Durango Nahuatl	Nahuatl, Durango
nlo	Ngul	Ngul
nlr	Ngarla	Ngarla
nlu	Nchumbulu	Nchumbulu
nlv	Orizaba Nahuatl	Nahuatl, Orizaba
nlx	Nahali	Nahali
nly	Nyamal	Nyamal
nma	Maram Naga	Naga, Maram
nmb	Big Nambas	Nambas, Big
nmc	Ngam	Ngam
nmd	Ndumu	Ndumu
nme	Mzieme Naga	Naga, Mzieme
nmf	Tangkhul Naga	Naga, Tangkhul
nmg	Ngumba	Ngumba
nmh	Monsang Naga	Naga, Monsang
nmi	Nyam	Nyam
nmj	Ngombe (Central African Republic)	Ngombe (Central African Republic)
nmk	Namakura	Namakura
nml	Ndemli	Ndemli
nmm	Manangba	Manangba
nmn	!Xóõ	!Xóõ
nmo	Moyon Naga	Naga, Moyon
nmp	Nimanbur	Nimanbur
nmq	Nambya	Nambya
nmr	Nimbari	Nimbari
nms	Letemboi	Letemboi
nmt	Namonuito	Namonuito
nmu	Northeast Maidu	Maidu, Northeast
nmv	Ngamini	Ngamini
nmw	Nimoa	Nimoa
nmx	Nama (Papua New Guinea)	Nama (Papua New Guinea)
nmy	Namuyi	Namuyi
nmz	Nawdm	Nawdm
nna	Nyangumarta	Nyangumarta
nnb	Nande	Nande
nnc	Nancere	Nancere
nnd	West Ambae	Ambae, West
nne	Ngandyera	Ngandyera
nnf	Ngaing	Ngaing
nng	Maring Naga	Naga, Maring
nnh	Ngiemboon	Ngiemboon
nni	North Nuaulu	Nuaulu, North
nnj	Nyangatom	Nyangatom
nnk	Nankina	Nankina
nnl	Northern Rengma Naga	Naga, Northern Rengma
nnm	Namia	Namia
nnn	Ngete	Ngete
nno	Norwegian Nynorsk	Norwegian Nynorsk
nnp	Wancho Naga	Naga, Wancho
nnq	Ngindo	Ngindo
nnr	Narungga	Narungga
nns	Ningye	Ningye
nnt	Nanticoke	Nanticoke
nnu	Dwang	Dwang
nnv	Nugunu (Australia)	Nugunu (Australia)
nnw	Southern Nuni	Nuni, Southern
nnx	Ngong	Ngong
nny	Nyangga	Nyangga
nnz	Nda'nda'	Nda'nda'
noa	Woun Meu	Woun Meu
nob	Norwegian Bokmål	Norwegian Bokmål
noc	Nuk	Nuk
nod	Northern Thai	Thai, Northern
noe	Nimadi	Nimadi
nof	Nomane	Nomane
nog	Nogai	Nogai
noh	Nomu	Nomu
noi	Noiri	Noiri
nok	Nooksack	Nooksack
nom	Nocamán	Nocamán
non	Old Norse	Norse, Old
noo	Nootka	Nootka
nop	Numanggang	Numanggang
noq	Ngongo	Ngongo
nor	Norwegian	Norwegian
nos	Southern Yi	Yi, Southern
not	Nomatsiguenga	Nomatsiguenga
nou	Ewage-Notu	Ewage-Notu
nov	Novial	Novial
now	Nyambo	Nyambo
noy	Noy	Noy
noz	Nayi	Nayi
npa	Nar Phu	Nar Phu
npb	Nupbikha	Nupbikha
nph	Phom Naga	Naga, Phom
npl	Southeastern Puebla Nahuatl	Nahuatl, Southeastern Puebla
npn	Mondropolon	Mondropolon
npo	Pochuri Naga	Naga, Pochuri
nps	Nipsan	Nipsan
npu	Puimei Naga	Naga, Puimei
npy	Napu	Napu
nqg	Ede Nago	Ede Nago
nqk	Kura Ede Nago	Ede Nago, Kura
nqm	Ndom	Ndom
nqn	Nen	Nen
nqo	N'Ko	N'Ko
nra	Ngom	Ngom
nrb	Nara	Nara
nrc	Noric	Noric
nre	Southern Rengma Naga	Naga, Southern Rengma
nrg	Narango	Narango
nri	Chokri Naga	Naga, Chokri
nrl	Ngarluma	Ngarluma
nrm	Narom	Narom
nrn	Norn	Norn
nrp	North Picene	Picene, North
nrr	Norra	Norra
nrt	Northern Kalapuya	Kalapuya, Northern
nrx	Ngurmbur	Ngurmbur
nrz	Lala	Lala
nsa	Sangtam Naga	Naga, Sangtam
nsc	Nshi	Nshi
nse	Nsenga	Nsenga
nsg	Ngasa	Ngasa
nsh	Ngoshie	Ngoshie
nsi	Nigerian Sign Language	Nigerian Sign Language
nsk	Naskapi	Naskapi
nsl	Norwegian Sign Language	Norwegian Sign Language
nsm	Sumi Naga	Naga, Sumi
nsn	Nehan	Nehan
nso	Northern Sotho	Sotho, Northern
nso	Pedi	Pedi
nso	Sepedi	Sepedi
nsp	Nepalese Sign Language	Nepalese Sign Language
nsq	Northern Sierra Miwok	Miwok, Northern Sierra
nsr	Maritime Sign Language	Maritime Sign Language
nss	Nali	Nali
nst	Tase Naga	Naga, Tase
nsu	Sierra Negra Nahuatl	Nahuatl, Sierra Negra
nsw	Navut	Navut
nsx	Nsongo	Nsongo
nsz	Nisenan	Nisenan
nte	Nathembo	Nathembo
nti	Natioro	Natioro
ntj	Ngaanyatjarra	Ngaanyatjarra
ntk	Ikoma	Ikoma
ntm	Nateni	Nateni
nto	Ntomba	Ntomba
ntp	Northern Tepehuan	Tepehuan, Northern
ntr	Delo	Delo
nts	Natagaimas	Natagaimas
ntw	Nottoway	Nottoway
nty	Mantsi	Mantsi
ntz	Natanzi	Natanzi
nua	Yuaga	Yuaga
nuc	Nukuini	Nukuini
nud	Ngala	Ngala
nue	Ngundu	Ngundu
nuf	Nusu	Nusu
nug	Nungali	Nungali
nuh	Ndunda	Ndunda
nui	Ngumbi	Ngumbi
nuj	Nyole	Nyole
nul	Nusa Laut	Nusa Laut
num	Niuafo'ou	Niuafo'ou
nun	Nung (Myanmar)	Nung (Myanmar)
nuo	Nguôn	Nguôn
nup	Nupe-Nupe-Tako	Nupe-Nupe-Tako
nuq	Nukumanu	Nukumanu
nur	Nukuria	Nukuria
nus	Nuer	Nuer
nut	Nung (Viet Nam)	Nung (Viet Nam)
nuu	Ngbundu	Ngbundu
nuv	Northern Nuni	Nuni, Northern
nuw	Nguluwan	Nguluwan
nux	Mehek	Mehek
nuy	Nunggubuyu	Nunggubuyu
nuz	Tlamacazapa Nahuatl	Nahuatl, Tlamacazapa
nvh	Nasarian	Nasarian
nvm	Namiae	Namiae
nwa	Nawathinehena	Nawathinehena
nwb	Nyabwa	Nyabwa
nwc	Classical Nepal Bhasa	Nepal Bhasa, Classical
nwc	Classical Newari	Newari, Classical
nwc	Old Newari	Newari, Old
nwe	Ngwe	Ngwe
nwi	Southwest Tanna	Tanna, Southwest
nwm	Nyamusa-Molo	Nyamusa-Molo
nwr	Nawaru	Nawaru
nwx	Middle Newar	Newar, Middle
nwy	Nottoway-Meherrin	Nottoway-Meherrin
nxa	Nauete	Nauete
nxd	Ngando (Democratic Republic of Congo)	Ngando (Democratic Republic of Congo)
nxe	Nage	Nage
nxg	Ngad'a	Ngad'a
nxi	Nindi	Nindi
nxj	Nyadu	Nyadu
nxl	South Nuaulu	Nuaulu, South
nxm	Numidian	Numidian
nxn	Ngawun	Ngawun
nxr	Ninggerum	Ninggerum
nxu	Narau	Narau
nxx	Nafri	Nafri
nya	Chewa	Chewa
nya	Chichewa	Chichewa
nya	Nyanja	Nyanja
nyb	Nyangbo	Nyangbo
nyc	Nyanga-li	Nyanga-li
nyd	Nyore	Nyore
nye	Nyengo	Nyengo
nyf	Giryama	Giryama
nyg	Nyindu	Nyindu
nyh	Nyigina	Nyigina
nyi	Ama (Sudan)	Ama (Sudan)
nyj	Nyanga	Nyanga
nyk	Nyaneka	Nyaneka
nyl	Nyeu	Nyeu
nym	Nyamwezi	Nyamwezi
nyn	Nyankole	Nyankole
nyo	Nyoro	Nyoro
nyp	Nyang'i	Nyang'i
nyq	Nayini	Nayini
nys	Nyunga	Nyunga
nyt	Nyawaygi	Nyawaygi
nyu	Nyungwe	Nyungwe
nyv	Nyulnyul	Nyulnyul
nyw	Nyaw	Nyaw
nyx	Nganyaywana	Nganyaywana
nyy	Nyakyusa-Ngonde	Nyakyusa-Ngonde
nza	Tigon Mbembe	Mbembe, Tigon
nzb	Njebi	Njebi
nzi	Nzima	Nzima
nzk	Nzakara	Nzakara
nzm	Zeme Naga	Naga, Zeme
nzs	New Zealand Sign Language	New Zealand Sign Language
nzu	Teke-Nzikou	Teke-Nzikou
nzy	Nzakambay	Nzakambay
oaa	Orok	Orok
oac	Oroch	Oroch
oar	Ancient Aramaic (up to 700 BCE)	Aramaic, Ancient (up to 700 BCE)
oar	Old Aramaic (up to 700 BCE)	Aramaic, Old (up to 700 BCE)
oav	Old Avar	Avar, Old
obi	Obispeño	Obispeño
obl	Oblo	Oblo
obm	Moabite	Moabite
obo	Obo Manobo	Manobo, Obo
obr	Old Burmese	Burmese, Old
obt	Old Breton	Breton, Old
obu	Obulom	Obulom
oca	Ocaina	Ocaina
och	Old Chinese	Chinese, Old
oci	Occitan (post 1500)	Occitan (post 1500)
oco	Old Cornish	Cornish, Old
ocu	Atzingo Matlatzinca	Matlatzinca, Atzingo
oda	Odut	Odut
odk	Od	Od
odt	Old Dutch	Dutch, Old
odu	Odual	Odual
ofo	Ofo	Ofo
ofs	Old Frisian	Frisian, Old
ofu	Efutop	Efutop
ogb	Ogbia	Ogbia
ogc	Ogbah	Ogbah
oge	Old Georgian	Georgian, Old
ogg	Ogbogolo	Ogbogolo
ogn	Ogan	Ogan
ogo	Khana	Khana
ogu	Ogbronuagum	Ogbronuagum
oht	Old Hittite	Hittite, Old
ohu	Old Hungarian	Hungarian, Old
oia	Oirata	Oirata
oin	Inebu One	One, Inebu
ojb	Northwestern Ojibwa	Ojibwa, Northwestern
ojc	Central Ojibwa	Ojibwa, Central
ojg	Eastern Ojibwa	Ojibwa, Eastern
oji	Ojibwa	Ojibwa
ojp	Old Japanese	Japanese, Old
ojs	Severn Ojibwa	Ojibwa, Severn
ojv	Ontong Java	Ontong Java
ojw	Western Ojibwa	Ojibwa, Western
oka	Okanagan	Okanagan
okb	Okobo	Okobo
okd	Okodia	Okodia
oke	Okpe (Southwestern Edo)	Okpe (Southwestern Edo)
okh	Koresh-e Rostam	Koresh-e Rostam
oki	Okiek	Okiek
okj	Oko-Juwoi	Oko-Juwoi
okk	Kwamtim One	One, Kwamtim
okl	Old Kentish Sign Language	Kentish Sign Language, Old
okm	Middle Korean (10th-16th cent.)	Korean, Middle (10th-16th cent.)
okn	Oki-No-Erabu	Oki-No-Erabu
oko	Old Korean (3rd-9th cent.)	Korean, Old (3rd-9th cent.)
okr	Kirike	Kirike
oks	Oko-Eni-Osayen	Oko-Eni-Osayen
oku	Oku	Oku
okx	Okpe (Northwestern Edo)	Okpe (Northwestern Edo)
ola	Walungge	Walungge
old	Mochi	Mochi
ole	Olekha	Olekha
olm	Oloma	Oloma
olo	Livvi	Livvi
oma	Omaha-Ponca	Omaha-Ponca
omb	East Ambae	Ambae, East
omc	Mochica	Mochica
ome	Omejes	Omejes
omg	Omagua	Omagua
omi	Omi	Omi
omk	Omok	Omok
oml	Ombo	Ombo
omn	Minoan	Minoan
omo	Utarmbung	Utarmbung
omp	Old Manipuri	Manipuri, Old
omr	Old Marathi	Marathi, Old
omt	Omotik	Omotik
omu	Omurano	Omurano
omw	South Tairora	Tairora, South
omx	Old Mon	Mon, Old
ona	Ona	Ona
onb	Lingao	Lingao
one	Oneida	Oneida
ong	Olo	Olo
oni	Onin	Onin
onj	Onjob	Onjob
onk	Kabore One	One, Kabore
onn	Onobasulu	Onobasulu
ono	Onondaga	Onondaga
onp	Sartang	Sartang
onr	Northern One	One, Northern
ons	Ono	Ono
ont	Ontenu	Ontenu
onu	Unua	Unua
onw	Old Nubian	Nubian, Old
onx	Onin Based Pidgin	Onin Based Pidgin
ood	Tohono O'odham	Tohono O'odham
oog	Ong	Ong
oon	Önge	Önge
oor	Oorlams	Oorlams
oos	Old Ossetic	Ossetic, Old
opa	Okpamheri	Okpamheri
ope	Old Persian	Persian, Old
opk	Kopkaka	Kopkaka
opm	Oksapmin	Oksapmin
opo	Opao	Opao
opt	Opata	Opata
opy	Ofayé	Ofayé
ora	Oroha	Oroha
orc	Orma	Orma
ore	Orejón	Orejón
org	Oring	Oring
orh	Oroqen	Oroqen
ori	Oriya	Oriya
ork	Orokaiva	Orokaiva
orm	Oromo	Oromo
orn	Orang Kanaq	Orang Kanaq
oro	Orokolo	Orokolo
orr	Oruma	Oruma
ors	Orang Seletar	Orang Seletar
ort	Adivasi Oriya	Oriya, Adivasi
oru	Ormuri	Ormuri
orv	Old Russian	Russian, Old
orw	Oro Win	Oro Win
orx	Oro	Oro
orz	Ormu	Ormu
osa	Osage	Osage
osc	Oscan	Oscan
osi	Osing	Osing
oso	Ososo	Ososo
osp	Old Spanish	Spanish, Old
oss	Ossetian	Ossetian
oss	Ossetic	Ossetic
ost	Osatu	Osatu
osu	Southern One	One, Southern
osx	Old Saxon	Saxon, Old
ota	Ottoman Turkish (1500-1928)	Turkish, Ottoman (1500-1928)
otb	Old Tibetan	Tibetan, Old
otd	Dohoi	Dohoi
ote	Mezquital Otomi	Otomi, Mezquital
oti	Oti	Oti
otk	Old Turkish	Turkish, Old
otl	Tilapa Otomi	Otomi, Tilapa
otm	Eastern Highland Otomi	Otomi, Eastern Highland
otn	Tenango Otomi	Otomi, Tenango
otq	Querétaro Otomi	Otomi, Querétaro
otr	Otoro	Otoro
ots	Estado de México Otomi	Otomi, Estado de México
ott	Temoaya Otomi	Otomi, Temoaya
otu	Otuke	Otuke
otw	Ottawa	Ottawa
otx	Texcatepec Otomi	Otomi, Texcatepec
oty	Old Tamil	Tamil, Old
otz	Ixtenco Otomi	Otomi, Ixtenco
oua	Tagargrent	Tagargrent
oub	Glio-Oubi	Glio-Oubi
oue	Oune	Oune
oui	Old Uighur	Uighur, Old
oum	Ouma	Ouma
oun	!O!ung	!O!ung
owi	Owiniga	Owiniga
owl	Old Welsh	Welsh, Old
oyb	Oy	Oy
oyd	Oyda	Oyda
oym	Wayampi	Wayampi
oyy	Oya'oya	Oya'oya
ozm	Koonzime	Koonzime
pab	Parecís	Parecís
pac	Pacoh	Pacoh
pad	Paumarí	Paumarí
pae	Pagibete	Pagibete
paf	Paranawát	Paranawát
pag	Pangasinan	Pangasinan
pah	Tenharim	Tenharim
pai	Pe	Pe
paj	Ipeka-Tapuia	Ipeka-Tapuia
pak	Parakanã	Parakanã
pal	Pahlavi	Pahlavi
pam	Pampanga	Pampanga
pan	Panjabi	Panjabi
pan	Punjabi	Punjabi
pao	Northern Paiute	Paiute, Northern
pap	Papiamento	Papiamento
paq	Parya	Parya
par	Panamint	Panamint
pas	Papasena	Papasena
pat	Papitalai	Papitalai
pau	Palauan	Palauan
pav	Pakaásnovos	Pakaásnovos
paw	Pawnee	Pawnee
pax	Pankararé	Pankararé
pay	Pech	Pech
paz	Pankararú	Pankararú
pbb	Páez	Páez
pbc	Patamona	Patamona
pbe	Mezontla Popoloca	Popoloca, Mezontla
pbf	Coyotepec Popoloca	Popoloca, Coyotepec
pbg	Paraujano	Paraujano
pbh	E'ñapa Woromaipu	E'ñapa Woromaipu
pbi	Parkwa	Parkwa
pbl	Mak (Nigeria)	Mak (Nigeria)
pbn	Kpasam	Kpasam
pbo	Papel	Papel
pbp	Badyara	Badyara
pbr	Pangwa	Pangwa
pbs	Central Pame	Pame, Central
pbt	Southern Pashto	Pashto, Southern
pbu	Northern Pashto	Pashto, Northern
pbv	Pnar	Pnar
pby	Pyu	Pyu
pbz	Palu	Palu
pca	Santa Inés Ahuatempan Popoloca	Popoloca, Santa Inés Ahuatempan
pcb	Pear	Pear
pcc	Bouyei	Bouyei
pcd	Picard	Picard
pce	Pale Palaung	Palaung, Pale
pcf	Paliyan	Paliyan
pcg	Paniya	Paniya
pch	Pardhan	Pardhan
pci	Duruwa	Duruwa
pcj	Parenga	Parenga
pck	Paite Chin	Chin, Paite
pcl	Pardhi	Pardhi
pcm	Nigerian Pidgin	Pidgin, Nigerian
pcn	Piti	Piti
pcp	Pacahuara	Pacahuara
pcr	Panang	Panang
pcw	Pyapun	Pyapun
pda	Anam	Anam
pdc	Pennsylvania German	German, Pennsylvania
pdi	Pa Di	Pa Di
pdn	Podena	Podena
pdo	Padoe	Padoe
pdt	Plautdietsch	Plautdietsch
pdu	Kayan	Kayan
pea	Peranakan Indonesian	Indonesian, Peranakan
peb	Eastern Pomo	Pomo, Eastern
pec	Southern Pesisir	Pesisir, Southern
ped	Mala (Papua New Guinea)	Mala (Papua New Guinea)
pee	Taje	Taje
pef	Northeastern Pomo	Pomo, Northeastern
peg	Pengo	Pengo
peh	Bonan	Bonan
pei	Chichimeca-Jonaz	Chichimeca-Jonaz
pej	Northern Pomo	Pomo, Northern
pek	Penchal	Penchal
pel	Pekal	Pekal
pem	Phende	Phende
pen	Penesak	Penesak
peo	Old Persian (ca. 600-400 B.C.)	Persian, Old (ca. 600-400 B.C.)
pep	Kunja	Kunja
peq	Southern Pomo	Pomo, Southern
pes	Western Farsi	Farsi, Western
pev	Pémono	Pémono
pex	Petats	Petats
pey	Petjo	Petjo
pez	Eastern Penan	Penan, Eastern
pfa	Pááfang	Pááfang
pfe	Peere	Peere
pfl	Pfaelzisch	Pfaelzisch
pga	Sudanese Creole Arabic	Creole Arabic, Sudanese
pgg	Pangwali	Pangwali
pgi	Pagi	Pagi
pgk	Rerep	Rerep
pgn	Paelignian	Paelignian
pgs	Pangseng	Pangseng
pgu	Pagu	Pagu
pgy	Pongyong	Pongyong
pha	Pa-Hng	Pa-Hng
phd	Phudagi	Phudagi
phg	Phuong	Phuong
phh	Phula	Phula
phk	Phake	Phake
phl	Phalura	Phalura
phm	Phimbi	Phimbi
phn	Phoenician	Phoenician
pho	Phunoi	Phunoi
phq	Phana'	Phana'
phr	Pahari-Potwari	Pahari-Potwari
pht	Phu Thai	Phu Thai
phu	Phuan	Phuan
phv	Pahlavani	Pahlavani
phw	Phangduwali	Phangduwali
pia	Pima Bajo	Pima Bajo
pib	Yine	Yine
pic	Pinji	Pinji
pid	Piaroa	Piaroa
pie	Piro	Piro
pif	Pingelapese	Pingelapese
pig	Pisabo	Pisabo
pih	Pitcairn-Norfolk	Pitcairn-Norfolk
pii	Pini	Pini
pij	Pijao	Pijao
pil	Yom	Yom
pim	Powhatan	Powhatan
pin	Piame	Piame
pio	Piapoco	Piapoco
pip	Pero	Pero
pir	Piratapuyo	Piratapuyo
pis	Pijin	Pijin
pit	Pitta Pitta	Pitta Pitta
piu	Pintupi-Luritja	Pintupi-Luritja
piv	Pileni	Pileni
piw	Pimbwe	Pimbwe
pix	Piu	Piu
piy	Piya-Kwonci	Piya-Kwonci
piz	Pije	Pije
pjt	Pitjantjatjara	Pitjantjatjara
pka	Ardhamāgadhī Prākrit	Prākrit, Ardhamāgadhī
pkb	Upper Pokomo	Pokomo, Upper
pkc	Paekche	Paekche
pkg	Pak-Tong	Pak-Tong
pkh	Pankhu	Pankhu
pkn	Pakanha	Pakanha
pko	Pökoot	Pökoot
pkp	Pukapuka	Pukapuka
pkr	Attapady Kurumba	Kurumba, Attapady
pks	Pakistan Sign Language	Pakistan Sign Language
pkt	Maleng	Maleng
pku	Paku	Paku
pla	Miani	Miani
plb	Polonombauk	Polonombauk
plc	Central Palawano	Palawano, Central
pld	Polari	Polari
ple	Palu'e	Palu'e
plg	Pilagá	Pilagá
plh	Paulohi	Paulohi
pli	Pali	Pali
plj	Polci	Polci
plk	Kohistani Shina	Shina, Kohistani
pll	Shwe Palaung	Palaung, Shwe
plm	Palembang	Palembang
pln	Palenquero	Palenquero
plo	Oluta Popoluca	Popoluca, Oluta
plp	Palpa	Palpa
plq	Palaic	Palaic
plr	Palaka Senoufo	Senoufo, Palaka
pls	San Marcos Tlalcoyalco Popoloca	Popoloca, San Marcos Tlalcoyalco
plt	Plateau Malagasy	Malagasy, Plateau
plu	Palikúr	Palikúr
plv	Southwest Palawano	Palawano, Southwest
plw	Brooke's Point Palawano	Palawano, Brooke's Point
ply	Bolyu	Bolyu
plz	Paluan	Paluan
pma	Paama	Paama
pmb	Pambia	Pambia
pmc	Palumata	Palumata
pme	Pwaamei	Pwaamei
pmh	Māhārāṣṭri Prākrit	Prākrit, Māhārāṣṭri
pmi	Northern Pumi	Pumi, Northern
pmj	Southern Pumi	Pumi, Southern
pmk	Pamlico	Pamlico
pml	Lingua Franca	Lingua Franca
pmm	Pomo	Pomo
pmn	Pam	Pam
pmo	Pom	Pom
pmq	Northern Pame	Pame, Northern
pmr	Paynamar	Paynamar
pms	Piemontese	Piemontese
pmt	Tuamotuan	Tuamotuan
pmu	Mirpur Panjabi	Panjabi, Mirpur
pmw	Plains Miwok	Miwok, Plains
pmx	Poumei Naga	Naga, Poumei
pmz	Southern Pame	Pame, Southern
pna	Punan Bah-Biau	Punan Bah-Biau
pnb	Western Panjabi	Panjabi, Western
pnc	Pannei	Pannei
pne	Western Penan	Penan, Western
png	Pongu	Pongu
pnh	Penrhyn	Penrhyn
pni	Aoheng	Aoheng
pnm	Punan Batu 1	Punan Batu 1
pnn	Pinai-Hagahai	Pinai-Hagahai
pno	Panobo	Panobo
pnp	Pancana	Pancana
pnq	Pana (Burkina Faso)	Pana (Burkina Faso)
pnr	Panim	Panim
pns	Ponosakan	Ponosakan
pnt	Pontic	Pontic
pnu	Jiongnai Bunu	Bunu, Jiongnai
pnv	Pinigura	Pinigura
pnw	Panytyima	Panytyima
pnx	Phong-Kniang	Phong-Kniang
pny	Pinyin	Pinyin
pnz	Pana (Central African Republic)	Pana (Central African Republic)
poa	Eastern Pokomam	Pokomam, Eastern
pob	Western Pokomchí	Pokomchí, Western
poc	Central Pokomam	Pokomam, Central
pod	Ponares	Ponares
poe	San Juan Atzingo Popoloca	Popoloca, San Juan Atzingo
pof	Poke	Poke
pog	Potiguára	Potiguára
poh	Eastern Pokomchí	Pokomchí, Eastern
poi	Highland Popoluca	Popoluca, Highland
poj	Lower Pokomo	Pokomo, Lower
pok	Pokangá	Pokangá
pol	Polish	Polish
pom	Southeastern Pomo	Pomo, Southeastern
pon	Pohnpeian	Pohnpeian
poo	Central Pomo	Pomo, Central
pop	Pwapwa	Pwapwa
poq	Texistepec Popoluca	Popoluca, Texistepec
por	Portuguese	Portuguese
pos	Sayula Popoluca	Popoluca, Sayula
pot	Potawatomi	Potawatomi
pou	Southern Pokomam	Pokomam, Southern
pov	Upper Guinea Crioulo	Crioulo, Upper Guinea
pow	San Felipe Otlaltepec Popoloca	Popoloca, San Felipe Otlaltepec
pox	Polabian	Polabian
poy	Pogolo	Pogolo
ppa	Pao	Pao
ppe	Papi	Papi
ppi	Paipai	Paipai
ppk	Uma	Uma
ppl	Pipil	Pipil
ppm	Papuma	Papuma
ppn	Papapana	Papapana
ppo	Folopa	Folopa
ppp	Pelende	Pelende
ppq	Pei	Pei
ppr	Piru	Piru
pps	San Luís Temalacayuca Popoloca	Popoloca, San Luís Temalacayuca
ppt	Pare	Pare
ppu	Papora	Papora
ppv	Papavô	Papavô
pqa	Pa'a	Pa'a
pqm	Malecite-Passamaquoddy	Malecite-Passamaquoddy
prb	Lua'	Lua'
prc	Parachi	Parachi
prd	Parsi-Dari	Parsi-Dari
pre	Principense	Principense
prg	Prussian	Prussian
prh	Porohanon	Porohanon
pri	Paicî	Paicî
prk	Parauk	Parauk
prl	Peruvian Sign Language	Peruvian Sign Language
prm	Kibiri	Kibiri
prn	Prasuni	Prasuni
pro	Old Provençal (to 1500)	Provençal, Old (to 1500)
prp	Parsi	Parsi
prq	Ashéninka Perené	Ashéninka Perené
prr	Puri	Puri
prs	Dari	Dari
prs	Eastern Farsi	Farsi, Eastern
prt	Phai	Phai
pru	Puragi	Puragi
prw	Parawen	Parawen
prx	Purik	Purik
pry	Pray 3	Pray 3
prz	Providencia Sign Language	Providencia Sign Language
psa	Asue Awyu	Awyu, Asue
psc	Persian Sign Language	Persian Sign Language
psd	Plains Indian Sign Language	Plains Indian Sign Language
pse	Pasemah	Pasemah
psg	Penang Sign Language	Penang Sign Language
psh	Southwest Pashayi	Pashayi, Southwest
psi	Southeast Pashayi	Pashayi, Southeast
psl	Puerto Rican Sign Language	Puerto Rican Sign Language
psm	Pauserna	Pauserna
psn	Panasuan	Panasuan
pso	Polish Sign Language	Polish Sign Language
psp	Philippine Sign Language	Philippine Sign Language
psq	Pasi	Pasi
psr	Portuguese Sign Language	Portuguese Sign Language
pss	Kaulong	Kaulong
pst	Central Pashto	Pashto, Central
psu	Sauraseni Prākrit	Prākrit, Sauraseni
psw	Port Sandwich	Port Sandwich
psy	Piscataway	Piscataway
pta	Pai Tavytera	Pai Tavytera
pth	Pataxó Hã-Ha-Hãe	Pataxó Hã-Ha-Hãe
pti	Pintiini	Pintiini
ptn	Patani	Patani
pto	Zo'é	Zo'é
ptp	Patep	Patep
ptr	Piamatsina	Piamatsina
ptt	Enrekang	Enrekang
ptu	Bambam	Bambam
ptv	Port Vato	Port Vato
ptw	Pentlatch	Pentlatch
pty	Pathiya	Pathiya
pua	Western Highland Purepecha	Purepecha, Western Highland
pub	Purum	Purum
puc	Punan Merap	Punan Merap
pud	Punan Aput	Punan Aput
pue	Puelche	Puelche
puf	Punan Merah	Punan Merah
pug	Phuie	Phuie
pui	Puinave	Puinave
puj	Punan Tubu	Punan Tubu
puk	Pu Ko	Pu Ko
pum	Puma	Puma
pun	Pubian	Pubian
puo	Puoc	Puoc
pup	Pulabu	Pulabu
puq	Puquina	Puquina
pur	Puruborá	Puruborá
pus	Pushto	Pushto
put	Putoh	Putoh
puu	Punu	Punu
puw	Puluwatese	Puluwatese
pux	Puari	Puari
puy	Purisimeño	Purisimeño
puz	Purum Naga	Naga, Purum
pwa	Pawaia	Pawaia
pwb	Panawa	Panawa
pwg	Gapapaiwa	Gapapaiwa
pwm	Molbog	Molbog
pwn	Paiwan	Paiwan
pwo	Pwo Western Karen	Karen, Pwo Western
pwr	Powari	Powari
pww	Pwo Northern Karen	Karen, Pwo Northern
pxm	Quetzaltepec Mixe	Mixe, Quetzaltepec
pye	Pye Krumen	Krumen, Pye
pym	Fyam	Fyam
pyn	Poyanáwa	Poyanáwa
pyu	Puyuma	Puyuma
pyx	Pyu (Myanmar)	Pyu (Myanmar)
pyy	Pyen	Pyen
qua	Quapaw	Quapaw
qub	Huallaga Huánuco Quechua	Quechua, Huallaga Huánuco
quc	Central Quiché	Quiché, Central
qud	Calderón Highland Quichua	Quichua, Calderón Highland
que	Quechua	Quechua
quf	Lambayeque Quechua	Quechua, Lambayeque
qug	Chimborazo Highland Quichua	Quichua, Chimborazo Highland
quh	South Bolivian Quechua	Quechua, South Bolivian
qui	Quileute	Quileute
quj	Joyabaj Quiché	Quiché, Joyabaj
quk	Chachapoyas Quechua	Quechua, Chachapoyas
qul	North Bolivian Quechua	Quechua, North Bolivian
qum	Sipacapense	Sipacapense
qun	Quinault	Quinault
qup	Southern Pastaza Quechua	Quechua, Southern Pastaza
quq	Quinqui	Quinqui
qur	Yanahuanca Pasco Quechua	Quechua, Yanahuanca Pasco
qus	Santiago del Estero Quichua	Quichua, Santiago del Estero
qut	West Central Quiché	Quiché, West Central
quu	Eastern Quiché	Quiché, Eastern
quv	Sacapulteco	Sacapulteco
quw	Tena Lowland Quichua	Quichua, Tena Lowland
qux	Yauyos Quechua	Quechua, Yauyos
quy	Ayacucho Quechua	Quechua, Ayacucho
quz	Cusco Quechua	Quechua, Cusco
qva	Ambo-Pasco Quechua	Quechua, Ambo-Pasco
qvc	Cajamarca Quechua	Quechua, Cajamarca
qve	Eastern Apurímac Quechua	Quechua, Eastern Apurímac
qvh	Huamalíes-Dos de Mayo Huánuco Quechua	Quechua, Huamalíes-Dos de Mayo Huánuco
qvi	Imbabura Highland Quichua	Quichua, Imbabura Highland
qvj	Loja Highland Quichua	Quichua, Loja Highland
qvl	Cajatambo North Lima Quechua	Quechua, Cajatambo North Lima
qvm	Margos-Yarowilca-Lauricocha Quechua	Quechua, Margos-Yarowilca-Lauricocha
qvn	North Junín Quechua	Quechua, North Junín
qvo	Napo Lowland Quechua	Quechua, Napo Lowland
qvp	Pacaraos Quechua	Quechua, Pacaraos
qvs	San Martín Quechua	Quechua, San Martín
qvw	Huaylla Wanca Quechua	Quechua, Huaylla Wanca
qvy	Queyu	Queyu
qvz	Northern Pastaza Quichua	Quichua, Northern Pastaza
qwa	Corongo Ancash Quechua	Quechua, Corongo Ancash
qwc	Classical Quechua	Quechua, Classical
qwh	Huaylas Ancash Quechua	Quechua, Huaylas Ancash
qwm	Kuman (Russia)	Kuman (Russia)
qws	Sihuas Ancash Quechua	Quechua, Sihuas Ancash
qwt	Kwalhioqua-Tlatskanai	Kwalhioqua-Tlatskanai
qxa	Chiquián Ancash Quechua	Quechua, Chiquián Ancash
qxc	Chincha Quechua	Quechua, Chincha
qxh	Panao Huánuco Quechua	Quechua, Panao Huánuco
qxi	San Andrés Quiché	Quiché, San Andrés
qxl	Salasaca Highland Quichua	Quichua, Salasaca Highland
qxn	Northern Conchucos Ancash Quechua	Quechua, Northern Conchucos Ancash
qxo	Southern Conchucos Ancash Quechua	Quechua, Southern Conchucos Ancash
qxp	Puno Quechua	Quechua, Puno
qxq	Qashqa'i	Qashqa'i
qxr	Cañar Highland Quichua	Quichua, Cañar Highland
qxs	Southern Qiang	Qiang, Southern
qxt	Santa Ana de Tusi Pasco Quechua	Quechua, Santa Ana de Tusi Pasco
qxu	Arequipa-La Unión Quechua	Quechua, Arequipa-La Unión
qxw	Jauja Wanca Quechua	Quechua, Jauja Wanca
qya	Quenya	Quenya
raa	Dungmali	Dungmali
rab	Camling	Camling
rac	Rasawa	Rasawa
rad	Rade	Rade
rae	Ranau	Ranau
raf	Western Meohang	Meohang, Western
rag	Logooli	Logooli
rah	Rabha	Rabha
rai	Ramoaaina	Ramoaaina
raj	Rajasthani	Rajasthani
rak	Tulu-Bohuai	Tulu-Bohuai
ral	Ralte	Ralte
ram	Canela	Canela
ran	Riantana	Riantana
rao	Rao	Rao
rap	Rapanui	Rapanui
raq	Saam	Saam
rar	Cook Islands Maori	Maori, Cook Islands
rar	Rarotongan	Rarotongan
ras	Tegali	Tegali
rat	Razajerdi	Razajerdi
rau	Raute	Raute
rav	Sampang	Sampang
raw	Rawang	Rawang
rax	Rang	Rang
ray	Rapa	Rapa
raz	Rahambuu	Rahambuu
rbb	Rumai Palaung	Palaung, Rumai
rcf	Réunion Creole French	Creole French, Réunion
rdb	Rudbari	Rudbari
rea	Rerau	Rerau
reb	Rembong	Rembong
ree	Rejang Kayan	Kayan, Rejang
reg	Kara (Tanzania)	Kara (Tanzania)
rei	Reli	Reli
rej	Rejang	Rejang
rel	Rendille	Rendille
rem	Remo	Remo
ren	Rengao	Rengao
rer	Rer Bare	Rer Bare
res	Reshe	Reshe
ret	Retta	Retta
rey	Reyesano	Reyesano
rga	Roria	Roria
rge	Romano-Greek	Romano-Greek
rgk	Rangkas	Rangkas
rgr	Resígaro	Resígaro
rgs	Southern Roglai	Roglai, Southern
rgu	Ringgou	Ringgou
rhg	Rohingya	Rohingya
rhp	Yahang	Yahang
ria	Riang (India)	Riang (India)
rie	Rien	Rien
rif	Tarifit	Tarifit
ril	Riang (Myanmar)	Riang (Myanmar)
rim	Nyaturu	Nyaturu
rin	Nungu	Nungu
rir	Ribun	Ribun
rit	Ritarungo	Ritarungo
riu	Riung	Riung
rjb	Rajbanshi	Rajbanshi
rjg	Rajong	Rajong
rji	Raji	Raji
rka	Kraol	Kraol
rkb	Rikbaktsa	Rikbaktsa
rkh	Rakahanga-Manihiki	Rakahanga-Manihiki
rkm	Marka	Marka
rma	Rama	Rama
rmb	Rembarunga	Rembarunga
rmc	Carpathian Romani	Romani, Carpathian
rmd	Traveller Danish	Danish, Traveller
rme	Angloromani	Angloromani
rmf	Kalo Finnish Romani	Romani, Kalo Finnish
rmg	Traveller Norwegian	Norwegian, Traveller
rmh	Murkim	Murkim
rmi	Lomavren	Lomavren
rmk	Romkun	Romkun
rml	Baltic Romani	Romani, Baltic
rmm	Roma	Roma
rmn	Balkan Romani	Romani, Balkan
rmo	Sinte Romani	Romani, Sinte
rmp	Rempi	Rempi
rmr	Caló	Caló
rms	Romanian Sign Language	Romanian Sign Language
rmt	Domari	Domari
rmu	Tavringer Romani	Romani, Tavringer
rmv	Romanova	Romanova
rmw	Welsh Romani	Romani, Welsh
rmx	Romam	Romam
rmy	Vlax Romani	Romani, Vlax
rna	Runa	Runa
rnd	Ruund	Ruund
rng	Ronga	Ronga
rnl	Ranglong	Ranglong
rnn	Roon	Roon
rnp	Rongpo	Rongpo
rnw	Rungwa	Rungwa
rob	Tae'	Tae'
roc	Cacgia Roglai	Roglai, Cacgia
rod	Rogo	Rogo
roe	Ronji	Ronji
rof	Rombo	Rombo
rog	Northern Roglai	Roglai, Northern
roh	Romansh	Romansh
rol	Romblomanon	Romblomanon
rom	Romany	Romany
ron	Romanian	Romanian
roo	Rotokas	Rotokas
rop	Kriol	Kriol
ror	Rongga	Rongga
rou	Runga	Runga
row	Dela-Oenale	Dela-Oenale
rpn	Repanbitip	Repanbitip
rpt	Rapting	Rapting
rri	Ririo	Ririo
rro	Waima	Waima
rsb	Romano-Serbian	Romano-Serbian
rsi	Rennellese Sign Language	Rennellese Sign Language
rsl	Russian Sign Language	Russian Sign Language
rth	Ratahan	Ratahan
rtm	Rotuman	Rotuman
rtw	Rathawi	Rathawi
rub	Gungu	Gungu
ruc	Ruuli	Ruuli
rue	Rusyn	Rusyn
ruf	Luguru	Luguru
rug	Roviana	Roviana
ruh	Ruga	Ruga
rui	Rufiji	Rufiji
ruk	Che	Che
run	Rundi	Rundi
ruo	Istro Romanian	Romanian, Istro
rup	Aromanian	Aromanian
rup	Arumanian	Arumanian
rup	Macedo Romanian	Romanian, Macedo
ruq	Megleno Romanian	Romanian, Megleno
rus	Russian	Russian
rut	Rutul	Rutul
ruu	Lanas Lobu	Lobu, Lanas
ruy	Mala (Nigeria)	Mala (Nigeria)
ruz	Ruma	Ruma
rwa	Rawo	Rawo
rwk	Rwa	Rwa
rwm	Amba (Uganda)	Amba (Uganda)
rwo	Rawa	Rawa
rwr	Marwari (India)	Marwari (India)
rws	Rawas	Rawas
ryn	Northern Amami-Oshima	Amami-Oshima, Northern
rys	Yaeyama	Yaeyama
ryu	Central Okinawan	Okinawan, Central
saa	Saba	Saba
sab	Buglere	Buglere
sac	Mesquakie	Mesquakie
sad	Sandawe	Sandawe
sae	Sabanês	Sabanês
saf	Safaliba	Safaliba
sag	Sango	Sango
sah	Yakut	Yakut
saj	Sahu	Sahu
sak	Sake	Sake
sam	Samaritan Aramaic	Aramaic, Samaritan
san	Sanskrit	Sanskrit
sao	Sause	Sause
sap	Sanapaná	Sanapaná
saq	Samburu	Samburu
sar	Saraveca	Saraveca
sas	Sasak	Sasak
sat	Santali	Santali
sau	Saleman	Saleman
sav	Saafi-Saafi	Saafi-Saafi
saw	Sawi	Sawi
sax	Sa	Sa
say	Saya	Saya
saz	Saurashtra	Saurashtra
sba	Ngambay	Ngambay
sbb	Simbo	Simbo
sbc	Kele (Papua New Guinea)	Kele (Papua New Guinea)
sbd	Southern Samo	Samo, Southern
sbe	Saliba	Saliba
sbf	Shabo	Shabo
sbg	Seget	Seget
sbh	Sori-Harengan	Sori-Harengan
sbi	Seti	Seti
sbj	Surbakhal	Surbakhal
sbk	Safwa	Safwa
sbl	Botolan Sambal	Sambal, Botolan
sbm	Sagala	Sagala
sbn	Sindhi Bhil	Bhil, Sindhi
sbo	Sabüm	Sabüm
sbp	Sangu (Tanzania)	Sangu (Tanzania)
sbq	Sileibi	Sileibi
sbr	Sembakung Murut	Sembakung Murut
sbs	Subiya	Subiya
sbt	Kimki	Kimki
sbu	Stod Bhoti	Bhoti, Stod
sbv	Sabine	Sabine
sbw	Simba	Simba
sbx	Seberuang	Seberuang
sby	Soli	Soli
sbz	Sara Kaba	Sara Kaba
sca	Sansu	Sansu
scb	Chut	Chut
sce	Dongxiang	Dongxiang
scf	San Miguel Creole French	Creole French, San Miguel
scg	Sanggau	Sanggau
sch	Sakachep	Sakachep
sci	Sri Lankan Creole Malay	Creole Malay, Sri Lankan
sck	Sadri	Sadri
scl	Shina	Shina
scn	Sicilian	Sicilian
sco	Scots	Scots
scp	Helambu Sherpa	Helambu Sherpa
scq	Sa'och	Sa'och
scs	North Slavey	Slavey, North
scu	Shumcho	Shumcho
scv	Sheni	Sheni
scw	Sha	Sha
scx	Sicel	Sicel
sda	Toraja-Sa'dan	Toraja-Sa'dan
sdb	Shabak	Shabak
sdc	Sassarese Sardinian	Sardinian, Sassarese
sdd	Semendo	Semendo
sde	Surubu	Surubu
sdf	Sarli	Sarli
sdg	Savi	Savi
sdh	Southern Kurdish	Kurdish, Southern
sdi	Sindang Kelingi	Sindang Kelingi
sdj	Suundi	Suundi
sdl	Saudi Arabian Sign Language	Saudi Arabian Sign Language
sdm	Semandang	Semandang
sdn	Gallurese Sardinian	Sardinian, Gallurese
sdo	Bukar Sadong	Bukar Sadong
sdp	Sherdukpen	Sherdukpen
sdr	Oraon Sadri	Sadri, Oraon
sds	Sened	Sened
sdt	Shuadit	Shuadit
sdu	Sarudu	Sarudu
sdx	Sibu	Sibu
sdz	Sallands	Sallands
sea	Semai	Semai
seb	Shempire Senoufo	Senoufo, Shempire
sec	Sechelt	Sechelt
sed	Sedang	Sedang
see	Seneca	Seneca
sef	Cebaara Senoufo	Senoufo, Cebaara
seg	Segeju	Segeju
seh	Sena	Sena
sei	Seri	Seri
sej	Sene	Sene
sek	Sekani	Sekani
sel	Selkup	Selkup
sen	Nanerigé Sénoufo	Sénoufo, Nanerigé
seo	Suarmin	Suarmin
sep	Sìcìté Sénoufo	Sénoufo, Sìcìté
seq	Senara Sénoufo	Sénoufo, Senara
ser	Serrano	Serrano
ses	Koyraboro Senni Songhai	Songhai, Koyraboro Senni
set	Sentani	Sentani
seu	Serui-Laut	Serui-Laut
sev	Nyarafolo Senoufo	Senoufo, Nyarafolo
sew	Sewa Bay	Sewa Bay
sey	Secoya	Secoya
sez	Senthang Chin	Chin, Senthang
sfb	French Belgian Sign Language	French Belgian Sign Language
sfb	Langue des signes de Belgique Francophone	Langue des signes de Belgique Francophone
sfs	South African Sign Language	South African Sign Language
sfw	Sehwi	Sehwi
sga	Old Irish (to 900)	Irish, Old (to 900)
sgb	Mag-Anchi Ayta	Ayta, Mag-Anchi
sge	Segai	Segai
sgg	Swiss-German Sign Language	Swiss-German Sign Language
sgh	Shughni	Shughni
sgi	Suga	Suga
sgk	Sangkong	Sangkong
sgl	Sanglechi-Ishkashimi	Sanglechi-Ishkashimi
sgm	Singa	Singa
sgo	Songa	Songa
sgp	Singpho	Singpho
sgr	Sangisari	Sangisari
sgt	Brokpake	Brokpake
sgu	Salas	Salas
sgw	Sebat Bet Gurage	Sebat Bet Gurage
sgx	Sierra Leone Sign Language	Sierra Leone Sign Language
sgz	Sursurunga	Sursurunga
sha	Shall-Zwall	Shall-Zwall
shb	Ninam	Ninam
shc	Sonde	Sonde
she	Sheko	Sheko
shg	Shua	Shua
shh	Shoshoni	Shoshoni
shi	Tachelhit	Tachelhit
shj	Shatt	Shatt
shk	Shilluk	Shilluk
shl	Shendu	Shendu
shm	Shahrudi	Shahrudi
shn	Shan	Shan
sho	Shanga	Shanga
shp	Shipibo-Conibo	Shipibo-Conibo
shq	Sala	Sala
shr	Shi	Shi
shs	Shuswap	Shuswap
sht	Shasta	Shasta
shu	Chadian Arabic	Arabic, Chadian
shv	Shehri	Shehri
shw	Shwai	Shwai
shx	She	She
shy	Tachawit	Tachawit
shz	Syenara Senoufo	Senoufo, Syenara
sia	Akkala Sami	Sami, Akkala
sib	Sebob Kenyah	Kenyah, Sebob
sic	Malinguat	Malinguat
sid	Sidamo	Sidamo
sie	Simaa	Simaa
sif	Siamou	Siamou
sig	Paasaal	Paasaal
sih	Zire	Zire
sii	Shom Peng	Shom Peng
sij	Numbami	Numbami
sik	Sikiana	Sikiana
sil	Tumulung Sisaala	Sisaala, Tumulung
sim	Mende (Papua New Guinea)	Mende (Papua New Guinea)
sin	Sinhala	Sinhala
sin	Sinhalese	Sinhalese
sip	Sikkimese	Sikkimese
siq	Sonia	Sonia
sir	Siri	Siri
sis	Siuslaw	Siuslaw
siu	Sinagen	Sinagen
siv	Sumariup	Sumariup
siw	Siwai	Siwai
six	Sumau	Sumau
siy	Sivandi	Sivandi
siz	Siwi	Siwi
sja	Epena	Epena
sjb	Sajau Basap	Sajau Basap
sjd	Kildin Sami	Sami, Kildin
sje	Pite Sami	Sami, Pite
sjg	Assangori	Assangori
sjk	Kemi Sami	Sami, Kemi
sjl	Sajalong	Sajalong
sjm	Mapun	Mapun
sjn	Sindarin	Sindarin
sjo	Xibe	Xibe
sjp	Surajpuri	Surajpuri
sjr	Siar-Lak	Siar-Lak
sjs	Senhaja De Srair	Senhaja De Srair
sjt	Ter Sami	Sami, Ter
sju	Ume Sami	Sami, Ume
sjw	Shawnee	Shawnee
ska	Skagit	Skagit
skb	Saek	Saek
skc	Sauk	Sauk
skd	Southern Sierra Miwok	Miwok, Southern Sierra
ske	Seke (Vanuatu)	Seke (Vanuatu)
skf	Sakirabiá	Sakirabiá
skg	Sakalava Malagasy	Malagasy, Sakalava
skh	Sikule	Sikule
ski	Sika	Sika
skj	Seke (Nepal)	Seke (Nepal)
skk	Sok	Sok
skl	Selako	Selako
skm	Sakam	Sakam
skn	Kolibugan Subanon	Subanon, Kolibugan
sko	Seko Tengah	Seko Tengah
skp	Sekapan	Sekapan
skq	Sininkere	Sininkere
skr	Seraiki	Seraiki
sks	Maia	Maia
skt	Sakata	Sakata
sku	Sakao	Sakao
skv	Skou	Skou
skw	Skepi Creole Dutch	Creole Dutch, Skepi
skx	Seko Padang	Seko Padang
sky	Sikaiana	Sikaiana
skz	Sekar	Sekar
slb	Kahumamahon Saluan	Saluan, Kahumamahon
slc	Sáliba	Sáliba
sld	Sissala	Sissala
sle	Sholaga	Sholaga
slf	Swiss-Italian Sign Language	Swiss-Italian Sign Language
slg	Selungai Murut	Selungai Murut
slh	Southern Puget Sound Salish	Salish, Southern Puget Sound
sli	Lower Silesian	Silesian, Lower
slj	Salumá	Salumá
slk	Slovak	Slovak
sll	Salt-Yui	Salt-Yui
slm	Pangutaran Sama	Sama, Pangutaran
sln	Salinan	Salinan
slp	Lamaholot	Lamaholot
slq	Salchuq	Salchuq
slr	Salar	Salar
sls	Singapore Sign Language	Singapore Sign Language
slt	Sila	Sila
slu	Selaru	Selaru
slv	Slovenian	Slovenian
slw	Sialum	Sialum
slx	Salampasu	Salampasu
sly	Selayar	Selayar
slz	Ma'ya	Ma'ya
sma	Southern Sami	Sami, Southern
smb	Simbari	Simbari
smc	Som	Som
smd	Sama	Sama
sme	Northern Sami	Sami, Northern
smf	Auwe	Auwe
smg	Simbali	Simbali
smh	Samei	Samei
smj	Lule Sami	Lule Sami
smk	Bolinao	Bolinao
sml	Central Sama	Sama, Central
smm	Musasa	Musasa
smn	Inari Sami	Sami, Inari
smo	Samoan	Samoan
smp	Samaritan	Samaritan
smq	Samo	Samo
smr	Simeulue	Simeulue
sms	Skolt Sami	Sami, Skolt
smt	Simte	Simte
smu	Somray	Somray
smv	Samvedi	Samvedi
smw	Sumbawa	Sumbawa
smx	Samba	Samba
smy	Semnani	Semnani
smz	Simeku	Simeku
sna	Shona	Shona
snb	Sebuyau	Sebuyau
snc	Sinaugoro	Sinaugoro
snd	Sindhi	Sindhi
sne	Jagoi	Jagoi
snf	Noon	Noon
sng	Sanga (Democratic Republic of Congo)	Sanga (Democratic Republic of Congo)
snh	Shinabo	Shinabo
sni	Sensi	Sensi
snj	Riverain Sango	Sango, Riverain
snk	Soninke	Soninke
snl	Sangil	Sangil
snm	Southern Ma'di	Ma'di, Southern
snn	Siona	Siona
sno	Snohomish	Snohomish
snp	Siane	Siane
snq	Sangu (Gabon)	Sangu (Gabon)
snr	Sihan	Sihan
sns	South West Bay	South West Bay
snu	Senggi	Senggi
snv	Sa'ban	Sa'ban
snw	Selee	Selee
snx	Sam	Sam
sny	Saniyo-Hiyewe	Saniyo-Hiyewe
snz	Sinsauru	Sinsauru
soa	Thai Song	Thai Song
sob	Sobei	Sobei
soc	So (Democratic Republic of Congo)	So (Democratic Republic of Congo)
sod	Songoora	Songoora
soe	Songomeno	Songomeno
sog	Sogdian	Sogdian
soh	Aka	Aka
soi	Sonha	Sonha
soj	Soi	Soi
sok	Sokoro	Sokoro
sol	Solos	Solos
som	Somali	Somali
soo	Songo	Songo
sop	Songe	Songe
soq	Kanasi	Kanasi
sor	Somrai	Somrai
sos	Seeku	Seeku
sot	Southern Sotho	Sotho, Southern
sou	Southern Thai	Thai, Southern
sov	Sonsorol	Sonsorol
sow	Sowanda	Sowanda
sox	So (Cameroon)	So (Cameroon)
soy	Miyobe	Miyobe
soz	Temi	Temi
spa	Castilian	Castilian
spa	Spanish	Spanish
spb	Sepa (Indonesia)	Sepa (Indonesia)
spc	Sapé	Sapé
spd	Saep	Saep
spe	Sepa (Papua New Guinea)	Sepa (Papua New Guinea)
spg	Sian	Sian
spi	Saponi	Saponi
spk	Sengo	Sengo
spl	Selepet	Selepet
spm	Sepen	Sepen
spo	Spokane	Spokane
spp	Supyire Senoufo	Senoufo, Supyire
spq	Loreto-Ucayali Spanish	Spanish, Loreto-Ucayali
spr	Saparua	Saparua
sps	Saposa	Saposa
spt	Spiti Bhoti	Bhoti, Spiti
spu	Sapuan	Sapuan
spx	South Picene	Picene, South
spy	Sabaot	Sabaot
sqa	Shama-Sambuga	Shama-Sambuga
sqh	Shau	Shau
sqi	Albanian	Albanian
sqm	Suma	Suma
sqn	Susquehannock	Susquehannock
sqo	Sorkhei	Sorkhei
sqq	Sou	Sou
sqs	Sri Lankan Sign Language	Sri Lankan Sign Language
sqt	Soqotri	Soqotri
squ	Squamish	Squamish
sra	Saruga	Saruga
srb	Sora	Sora
src	Logudorese Sardinian	Sardinian, Logudorese
srd	Sardinian	Sardinian
sre	Sara	Sara
srf	Nafi	Nafi
srg	Sulod	Sulod
srh	Sarikoli	Sarikoli
sri	Siriano	Siriano
srj	Serawai	Serawai
srk	Serudung Murut	Serudung Murut
srl	Isirawa	Isirawa
srm	Saramaccan	Saramaccan
srn	Sranan Tongo	Sranan Tongo
sro	Campidanese Sardinian	Sardinian, Campidanese
srp	Serbian	Serbian
srq	Sirionó	Sirionó
srr	Serer	Serer
srs	Sarsi	Sarsi
srt	Sauri	Sauri
sru	Suruí	Suruí
srv	Waray Sorsogon	Sorsogon, Waray
srw	Serua	Serua
srx	Sirmauri	Sirmauri
sry	Sera	Sera
srz	Shahmirzadi	Shahmirzadi
ssb	Southern Sama	Sama, Southern
ssd	Siroi	Siroi
sse	Balangingi	Balangingi
ssf	Thao	Thao
ssg	Seimat	Seimat
ssh	Shihhi Arabic	Arabic, Shihhi
ssi	Sansi	Sansi
ssj	Sausi	Sausi
ssk	Sunam	Sunam
ssl	Western Sisaala	Sisaala, Western
ssm	Semnam	Semnam
ssn	Sanye	Sanye
sso	Sissano	Sissano
ssp	Spanish Sign Language	Spanish Sign Language
ssq	So'a	So'a
ssr	Swiss-French Sign Language	Swiss-French Sign Language
sss	Sô	Sô
sst	Sinasina	Sinasina
ssu	Susuami	Susuami
ssv	Shark Bay	Shark Bay
ssw	Swati	Swati
ssx	Samberigi	Samberigi
ssy	Saho	Saho
ssz	Sengseng	Sengseng
sta	Settla	Settla
stb	Northern Subanen	Subanen, Northern
stc	Santa Cruz	Santa Cruz
std	Sentinel	Sentinel
ste	Liana-Seti	Liana-Seti
stf	Seta	Seta
stg	Trieng	Trieng
sth	Shelta	Shelta
sti	Bulo Stieng	Stieng, Bulo
stj	Matya Samo	Samo, Matya
stk	Arammba	Arammba
stl	Stellingwerfs	Stellingwerfs
stm	Setaman	Setaman
stn	Owa	Owa
sto	Stoney	Stoney
stp	Southeastern Tepehuan	Tepehuan, Southeastern
stq	Saterfriesisch	Saterfriesisch
str	Straits Salish	Salish, Straits
sts	Shumashti	Shumashti
stt	Budeh Stieng	Stieng, Budeh
stu	Samtao	Samtao
stw	Satawalese	Satawalese
sua	Sulka	Sulka
sub	Suku	Suku
suc	Western Subanon	Subanon, Western
sue	Suena	Suena
suf	Tarpia	Tarpia
sug	Suganga	Suganga
suh	Suba	Suba
sui	Suki	Suki
suj	Shubi	Shubi
suk	Sukuma	Sukuma
sul	Surigaonon	Surigaonon
sum	Sumo-Mayangna	Sumo-Mayangna
sun	Sundanese	Sundanese
suq	Suri	Suri
sur	Mwaghavul	Mwaghavul
sus	Susu	Susu
sut	Subtiaba	Subtiaba
suu	Sungkai	Sungkai
suv	Sulung	Sulung
suw	Sumbwa	Sumbwa
sux	Sumerian	Sumerian
suy	Suyá	Suyá
suz	Sunwar	Sunwar
sva	Svan	Svan
svb	Ulau-Suain	Ulau-Suain
svc	Vincentian Creole English	Creole English, Vincentian
sve	Serili	Serili
svk	Slovakian Sign Language	Slovakian Sign Language
svr	Savara	Savara
svs	Savosavo	Savosavo
svx	Skalvian	Skalvian
swa	Swahili (macrolanguage)	Swahili (macrolanguage)
swb	Comorian	Comorian
swc	Congo Swahili	Swahili, Congo
swe	Swedish	Swedish
swf	Sere	Sere
swg	Swabian	Swabian
swh	Swahili (individual language)	Swahili (individual language)
swi	Sui	Sui
swj	Sira	Sira
swk	Malawi Sena	Sena, Malawi
swl	Swedish Sign Language	Swedish Sign Language
swm	Samosa	Samosa
swn	Sawknah	Sawknah
swp	Suau	Suau
swq	Sharwa	Sharwa
swr	Saweru	Saweru
sws	Seluwasan	Seluwasan
swt	Sawila	Sawila
swu	Suwawa	Suwawa
swv	Shekhawati	Shekhawati
sww	Sowa	Sowa
swx	Suruahá	Suruahá
swy	Sarua	Sarua
sxc	Sicanian	Sicanian
sxe	Sighu	Sighu
sxg	Shixing	Shixing
sxk	Southern Kalapuya	Kalapuya, Southern
sxl	Selian	Selian
sxm	Samre	Samre
sxn	Sangir	Sangir
sxo	Sorothaptic	Sorothaptic
sxr	Saaroa	Saaroa
sxs	Sasaru	Sasaru
sxu	Upper Saxon	Saxon, Upper
sxw	Saxwe Gbe	Gbe, Saxwe
sya	Siang	Siang
syb	Central Subanen	Subanen, Central
syc	Classical Syriac	Syriac, Classical
syi	Seki	Seki
syk	Sukur	Sukur
syl	Sylheti	Sylheti
sym	Maya Samo	Samo, Maya
syn	Senaya	Senaya
syo	Suoy	Suoy
syr	Syriac	Syriac
sys	Sinyar	Sinyar
syw	Kagate	Kagate
sza	Semelai	Semelai
szb	Ngalum	Ngalum
szc	Semaq Beri	Semaq Beri
szd	Seru	Seru
sze	Seze	Seze
szg	Sengele	Sengele
szk	Sizaki	Sizaki
szl	Silesian	Silesian
szn	Sula	Sula
szp	Suabo	Suabo
szv	Isu (Fako Division)	Isu (Fako Division)
szw	Sawai	Sawai
taa	Lower Tanana	Tanana, Lower
tab	Tabassaran	Tabassaran
tac	Lowland Tarahumara	Tarahumara, Lowland
tad	Tause	Tause
tae	Tariano	Tariano
taf	Tapirapé	Tapirapé
tag	Tagoi	Tagoi
tah	Tahitian	Tahitian
taj	Eastern Tamang	Tamang, Eastern
tak	Tala	Tala
tal	Tal	Tal
tam	Tamil	Tamil
tan	Tangale	Tangale
tao	Yami	Yami
tap	Taabwa	Taabwa
taq	Tamasheq	Tamasheq
tar	Central Tarahumara	Tarahumara, Central
tas	Tay Boi	Tay Boi
tat	Tatar	Tatar
tau	Upper Tanana	Tanana, Upper
tav	Tatuyo	Tatuyo
taw	Tai	Tai
tax	Tamki	Tamki
tay	Atayal	Atayal
taz	Tocho	Tocho
tba	Aikanã	Aikanã
tbb	Tapeba	Tapeba
tbc	Takia	Takia
tbd	Kaki Ae	Kaki Ae
tbe	Tanimbili	Tanimbili
tbf	Mandara	Mandara
tbg	North Tairora	Tairora, North
tbh	Thurawal	Thurawal
tbi	Gaam	Gaam
tbj	Tiang	Tiang
tbk	Calamian Tagbanwa	Tagbanwa, Calamian
tbl	Tboli	Tboli
tbm	Tagbu	Tagbu
tbn	Barro Negro Tunebo	Tunebo, Barro Negro
tbo	Tawala	Tawala
tbp	Taworta	Taworta
tbr	Tumtum	Tumtum
tbs	Tanguat	Tanguat
tbt	Tembo (Kitembo)	Tembo (Kitembo)
tbu	Tubar	Tubar
tbv	Tobo	Tobo
tbw	Tagbanwa	Tagbanwa
tbx	Kapin	Kapin
tby	Tabaru	Tabaru
tbz	Ditammari	Ditammari
tca	Ticuna	Ticuna
tcb	Tanacross	Tanacross
tcc	Datooga	Datooga
tcd	Tafi	Tafi
tce	Southern Tutchone	Tutchone, Southern
tcf	Malinaltepec Tlapanec	Tlapanec, Malinaltepec
tcg	Tamagario	Tamagario
tch	Turks And Caicos Creole English	Creole English, Turks And Caicos
tci	Wára	Wára
tck	Tchitchege	Tchitchege
tcl	Taman (Myanmar)	Taman (Myanmar)
tcm	Tanahmerah	Tanahmerah
tcn	Tichurong	Tichurong
tco	Taungyo	Taungyo
tcp	Tawr Chin	Chin, Tawr
tcq	Kaiy	Kaiy
tcs	Torres Strait Creole	Creole, Torres Strait
tct	T'en	T'en
tcu	Southeastern Tarahumara	Tarahumara, Southeastern
tcw	Tecpatlán Totonac	Totonac, Tecpatlán
tcx	Toda	Toda
tcy	Tulu	Tulu
tcz	Thado Chin	Chin, Thado
tda	Tagdal	Tagdal
tdb	Panchpargania	Panchpargania
tdc	Emberá-Tadó	Emberá-Tadó
tdd	Tai Nüa	Tai Nüa
tdf	Talieng	Talieng
tdg	Western Tamang	Tamang, Western
tdh	Thulung	Thulung
tdi	Tomadino	Tomadino
tdj	Tajio	Tajio
tdk	Tambas	Tambas
tdl	Sur	Sur
tdn	Tondano	Tondano
tdo	Teme	Teme
tdq	Tita	Tita
tdr	Todrah	Todrah
tds	Doutai	Doutai
tdt	Tetun Dili	Tetun Dili
tdu	Tempasuk Dusun	Dusun, Tempasuk
tdv	Toro	Toro
tdx	Tandroy-Mahafaly Malagasy	Malagasy, Tandroy-Mahafaly
tdy	Tadyawan	Tadyawan
tea	Temiar	Temiar
teb	Tetete	Tetete
ted	Tepo Krumen	Krumen, Tepo
tee	Huehuetla Tepehua	Tepehua, Huehuetla
tef	Teressa	Teressa
teg	Teke-Tege	Teke-Tege
teh	Tehuelche	Tehuelche
tei	Torricelli	Torricelli
tek	Ibali Teke	Teke, Ibali
tel	Telugu	Telugu
tem	Timne	Timne
ten	Tama (Colombia)	Tama (Colombia)
teo	Teso	Teso
tep	Tepecano	Tepecano
teq	Temein	Temein
ter	Tereno	Tereno
tes	Tengger	Tengger
tet	Tetum	Tetum
teu	Soo	Soo
tev	Teor	Teor
tew	Tewa (USA)	Tewa (USA)
tex	Tennet	Tennet
tey	Tulishi	Tulishi
tfi	Tofin Gbe	Gbe, Tofin
tfn	Tanaina	Tanaina
tfo	Tefaro	Tefaro
tfr	Teribe	Teribe
tft	Ternate	Ternate
tga	Sagalla	Sagalla
tgb	Tebilung	Tebilung
tgc	Tigak	Tigak
tgd	Ciwogai	Ciwogai
tge	Eastern Gorkha Tamang	Tamang, Eastern Gorkha
tgf	Chalikha	Chalikha
tgg	Tangga	Tangga
tgh	Tobagonian Creole English	Creole English, Tobagonian
tgi	Lawunuia	Lawunuia
tgk	Tajik	Tajik
tgl	Tagalog	Tagalog
tgo	Sudest	Sudest
tgp	Tangoa	Tangoa
tgq	Tring	Tring
tgr	Tareng	Tareng
tgs	Nume	Nume
tgt	Central Tagbanwa	Tagbanwa, Central
tgu	Tanggu	Tanggu
tgv	Tingui-Boto	Tingui-Boto
tgw	Tagwana Senoufo	Senoufo, Tagwana
tgx	Tagish	Tagish
tgy	Togoyo	Togoyo
tha	Thai	Thai
thc	Tai Hang Tong	Tai Hang Tong
thd	Thayore	Thayore
the	Chitwania Tharu	Tharu, Chitwania
thf	Thangmi	Thangmi
thh	Northern Tarahumara	Tarahumara, Northern
thi	Tai Long	Tai Long
thk	Tharaka	Tharaka
thl	Dangaura Tharu	Tharu, Dangaura
thm	Aheu	Aheu
thn	Thachanadan	Thachanadan
thp	Thompson	Thompson
thq	Kochila Tharu	Tharu, Kochila
thr	Rana Tharu	Tharu, Rana
ths	Thakali	Thakali
tht	Tahltan	Tahltan
thu	Thuri	Thuri
thv	Tahaggart Tamahaq	Tamahaq, Tahaggart
thw	Thudam	Thudam
thx	The	The
thy	Tha	Tha
thz	Tayart Tamajeq	Tamajeq, Tayart
tia	Tidikelt Tamazight	Tamazight, Tidikelt
tic	Tira	Tira
tid	Tidong	Tidong
tie	Tingal	Tingal
tif	Tifal	Tifal
tig	Tigre	Tigre
tih	Timugon Murut	Murut, Timugon
tii	Tiene	Tiene
tij	Tilung	Tilung
tik	Tikar	Tikar
til	Tillamook	Tillamook
tim	Timbe	Timbe
tin	Tindi	Tindi
tio	Teop	Teop
tip	Trimuris	Trimuris
tiq	Tiéfo	Tiéfo
tir	Tigrinya	Tigrinya
tis	Masadiit Itneg	Itneg, Masadiit
tit	Tinigua	Tinigua
tiu	Adaseng	Adaseng
tiv	Tiv	Tiv
tiw	Tiwi	Tiwi
tix	Southern Tiwa	Tiwa, Southern
tiy	Tiruray	Tiruray
tiz	Tai Hongjin	Tai Hongjin
tja	Tajuasohn	Tajuasohn
tjg	Tunjung	Tunjung
tji	Northern Tujia	Tujia, Northern
tjm	Timucua	Timucua
tjn	Tonjon	Tonjon
tjo	Temacine Tamazight	Tamazight, Temacine
tjs	Southern Tujia	Tujia, Southern
tju	Tjurruru	Tjurruru
tka	Truká	Truká
tkb	Buksa	Buksa
tkd	Tukudede	Tukudede
tke	Takwane	Takwane
tkf	Tukumanféd	Tukumanféd
tkk	Takpa	Takpa
tkl	Tokelau	Tokelau
tkm	Takelma	Takelma
tkn	Toku-No-Shima	Toku-No-Shima
tkp	Tikopia	Tikopia
tkq	Tee	Tee
tkr	Tsakhur	Tsakhur
tks	Takestani	Takestani
tkt	Kathoriya Tharu	Tharu, Kathoriya
tku	Upper Necaxa Totonac	Totonac, Upper Necaxa
tkw	Teanu	Teanu
tkx	Tangko	Tangko
tkz	Takua	Takua
tla	Southwestern Tepehuan	Tepehuan, Southwestern
tlb	Tobelo	Tobelo
tlc	Yecuatla Totonac	Totonac, Yecuatla
tld	Talaud	Talaud
tle	Southern Marakwet	Marakwet, Southern
tlf	Telefol	Telefol
tlg	Tofanma	Tofanma
tlh	Klingon	Klingon
tlh	tlhIngan-Hol	tlhIngan-Hol
tli	Tlingit	Tlingit
tlj	Talinga-Bwisi	Talinga-Bwisi
tlk	Taloki	Taloki
tll	Tetela	Tetela
tlm	Tolomako	Tolomako
tln	Talondo'	Talondo'
tlo	Talodi	Talodi
tlp	Filomena Mata-Coahuitlán Totonac	Totonac, Filomena Mata-Coahuitlán
tlq	Tai Loi	Tai Loi
tlr	Talise	Talise
tls	Tambotalo	Tambotalo
tlt	Teluti	Teluti
tlu	Tulehu	Tulehu
tlv	Taliabu	Taliabu
tlw	South Wemale	Wemale, South
tlx	Khehek	Khehek
tly	Talysh	Talysh
tlz	Toala'	Toala'
tma	Tama (Chad)	Tama (Chad)
tmb	Katbol	Katbol
tmc	Tumak	Tumak
tmd	Haruai	Haruai
tme	Tremembé	Tremembé
tmf	Toba-Maskoy	Toba-Maskoy
tmg	Ternateño	Ternateño
tmh	Tamashek	Tamashek
tmi	Tutuba	Tutuba
tmj	Samarokena	Samarokena
tmk	Northwestern Tamang	Tamang, Northwestern
tml	Tamnim Citak	Citak, Tamnim
tmm	Tai Thanh	Tai Thanh
tmn	Taman (Indonesia)	Taman (Indonesia)
tmo	Temoq	Temoq
tmp	Tai Mène	Tai Mène
tmq	Tumleo	Tumleo
tmr	Jewish Babylonian Aramaic (ca. 200-1200 CE)	Aramaic, Jewish Babylonian (ca. 200-1200 CE)
tms	Tima	Tima
tmt	Tasmate	Tasmate
tmu	Iau	Iau
tmv	Tembo (Motembo)	Tembo (Motembo)
tmw	Temuan	Temuan
tmy	Tami	Tami
tmz	Tamanaku	Tamanaku
tna	Tacana	Tacana
tnb	Western Tunebo	Tunebo, Western
tnc	Tanimuca-Retuarã	Tanimuca-Retuarã
tnd	Angosturas Tunebo	Tunebo, Angosturas
tne	Tinoc Kallahan	Kallahan, Tinoc
tnf	Tangshewi	Tangshewi
tng	Tobanga	Tobanga
tnh	Maiani	Maiani
tni	Tandia	Tandia
tnj	Tanjong	Tanjong
tnk	Kwamera	Kwamera
tnl	Lenakel	Lenakel
tnm	Tabla	Tabla
tnn	North Tanna	Tanna, North
tno	Toromono	Toromono
tnp	Whitesands	Whitesands
tnq	Taino	Taino
tnr	Bedik	Bedik
tns	Tenis	Tenis
tnt	Tontemboan	Tontemboan
tnu	Tay Khang	Tay Khang
tnv	Tangchangya	Tangchangya
tnw	Tonsawang	Tonsawang
tnx	Tanema	Tanema
tny	Tongwe	Tongwe
tnz	Tonga (Thailand)	Tonga (Thailand)
tob	Toba	Toba
toc	Coyutla Totonac	Totonac, Coyutla
tod	Toma	Toma
toe	Tomedes	Tomedes
tof	Gizrra	Gizrra
tog	Tonga (Nyasa)	Tonga (Nyasa)
toh	Gitonga	Gitonga
toi	Tonga (Zambia)	Tonga (Zambia)
toj	Tojolabal	Tojolabal
tol	Tolowa	Tolowa
tom	Tombulu	Tombulu
ton	Tonga (Tonga Islands)	Tonga (Tonga Islands)
too	Xicotepec De Juárez Totonac	Totonac, Xicotepec De Juárez
top	Papantla Totonac	Totonac, Papantla
toq	Toposa	Toposa
tor	Togbo-Vara Banda	Banda, Togbo-Vara
tos	Highland Totonac	Totonac, Highland
tou	Tho	Tho
tov	Upper Taromi	Taromi, Upper
tow	Jemez	Jemez
tox	Tobian	Tobian
toy	Topoiyo	Topoiyo
toz	To	To
tpa	Taupota	Taupota
tpc	Azoyú Tlapanec	Tlapanec, Azoyú
tpe	Tippera	Tippera
tpg	Kula	Kula
tpi	Tok Pisin	Tok Pisin
tpj	Tapieté	Tapieté
tpk	Tupinikin	Tupinikin
tpl	Tlacoapa Tlapanec	Tlapanec, Tlacoapa
tpm	Tampulma	Tampulma
tpn	Tupinambá	Tupinambá
tpo	Tai Pao	Tai Pao
tpp	Pisaflores Tepehua	Tepehua, Pisaflores
tpq	Tukpa	Tukpa
tpr	Tuparí	Tuparí
tpt	Tlachichilco Tepehua	Tepehua, Tlachichilco
tpu	Tampuan	Tampuan
tpv	Tanapag	Tanapag
tpw	Tupí	Tupí
tpx	Acatepec Tlapanec	Tlapanec, Acatepec
tpy	Trumaí	Trumaí
tpz	Tinputz	Tinputz
tqb	Tembé	Tembé
tql	Lehali	Lehali
tqm	Turumsa	Turumsa
tqn	Tenino	Tenino
tqo	Toaripi	Toaripi
tqp	Tomoip	Tomoip
tqq	Tunni	Tunni
tqr	Torona	Torona
tqt	Western Totonac	Totonac, Western
tqu	Touo	Touo
tqw	Tonkawa	Tonkawa
tra	Tirahi	Tirahi
trb	Terebu	Terebu
trc	Copala Triqui	Triqui, Copala
trd	Turi	Turi
tre	East Tarangan	Tarangan, East
trf	Trinidadian Creole English	Creole English, Trinidadian
trg	Lishán Didán	Lishán Didán
trh	Turaka	Turaka
tri	Trió	Trió
trj	Toram	Toram
trl	Traveller Scottish	Scottish, Traveller
trm	Tregami	Tregami
trn	Trinitario	Trinitario
tro	Tarao Naga	Naga, Tarao
trp	Kok Borok	Kok Borok
trq	San Martín Itunyoso Triqui	Triqui, San Martín Itunyoso
trr	Taushiro	Taushiro
trs	Chicahuaxtla Triqui	Triqui, Chicahuaxtla
trt	Tunggare	Tunggare
tru	Turoyo	Turoyo
trv	Taroko	Taroko
trw	Torwali	Torwali
trx	Tringgus	Tringgus
try	Turung	Turung
trz	Torá	Torá
tsa	Tsaangi	Tsaangi
tsb	Tsamai	Tsamai
tsc	Tswa	Tswa
tsd	Tsakonian	Tsakonian
tse	Tunisian Sign Language	Tunisian Sign Language
tsf	Southwestern Tamang	Tamang, Southwestern
tsg	Tausug	Tausug
tsh	Tsuvan	Tsuvan
tsi	Tsimshian	Tsimshian
tsj	Tshangla	Tshangla
tsk	Tseku	Tseku
tsl	Ts'ün-Lao	Ts'ün-Lao
tsm	Turkish Sign Language	Turkish Sign Language
tsn	Tswana	Tswana
tso	Tsonga	Tsonga
tsp	Northern Toussian	Toussian, Northern
tsq	Thai Sign Language	Thai Sign Language
tsr	Akei	Akei
tss	Taiwan Sign Language	Taiwan Sign Language
tsu	Tsou	Tsou
tsv	Tsogo	Tsogo
tsw	Tsishingini	Tsishingini
tsx	Mubami	Mubami
tsy	Tebul Sign Language	Tebul Sign Language
tsz	Purepecha	Purepecha
tta	Tutelo	Tutelo
ttb	Gaa	Gaa
ttc	Tektiteko	Tektiteko
ttd	Tauade	Tauade
tte	Bwanabwana	Bwanabwana
ttf	Tuotomb	Tuotomb
ttg	Tutong 2	Tutong 2
tth	Upper Ta'oih	Ta'oih, Upper
tti	Tobati	Tobati
ttj	Tooro	Tooro
ttk	Totoro	Totoro
ttl	Totela	Totela
ttm	Northern Tutchone	Tutchone, Northern
ttn	Towei	Towei
tto	Lower Ta'oih	Ta'oih, Lower
ttp	Tombelala	Tombelala
ttq	Tawallammat Tamajaq	Tamajaq, Tawallammat
ttr	Tera	Tera
tts	Northeastern Thai	Thai, Northeastern
ttt	Muslim Tat	Tat, Muslim
ttu	Torau	Torau
ttv	Titan	Titan
ttw	Tutoh Kenyah	Kenyah, Tutoh
ttx	Tutong 1	Tutong 1
tty	Sikaritai	Sikaritai
ttz	Tsum	Tsum
tua	Wiarumus	Wiarumus
tub	Tübatulabal	Tübatulabal
tuc	Mutu	Mutu
tud	Tuxá	Tuxá
tue	Tuyuca	Tuyuca
tuf	Central Tunebo	Tunebo, Central
tug	Tunia	Tunia
tuh	Taulil	Taulil
tui	Tupuri	Tupuri
tuj	Tugutil	Tugutil
tuk	Turkmen	Turkmen
tul	Tula	Tula
tum	Tumbuka	Tumbuka
tun	Tunica	Tunica
tuo	Tucano	Tucano
tuq	Tedaga	Tedaga
tur	Turkish	Turkish
tus	Tuscarora	Tuscarora
tuu	Tututni	Tututni
tuv	Turkana	Turkana
tux	Tuxináwa	Tuxináwa
tuy	North Tugen	Tugen, North
tuz	Turka	Turka
tva	Vaghua	Vaghua
tvd	Tsuvadi	Tsuvadi
tve	Te'un	Te'un
tvk	Southeast Ambrym	Ambrym, Southeast
tvl	Tuvalu	Tuvalu
tvm	Tela-Masbuar	Tela-Masbuar
tvn	Tavoyan	Tavoyan
tvo	Tidore	Tidore
tvs	Taveta	Taveta
tvt	Tutsa Naga	Naga, Tutsa
tvw	Sedoa	Sedoa
tvy	Timor Pidgin	Pidgin, Timor
twa	Twana	Twana
twb	Western Tawbuid	Tawbuid, Western
twc	Teshenawa	Teshenawa
twd	Twents	Twents
twe	Tewa (Indonesia)	Tewa (Indonesia)
twf	Northern Tiwa	Tiwa, Northern
twg	Tereweng	Tereweng
twh	Tai Dón	Tai Dón
twi	Twi	Twi
twl	Tawara	Tawara
twm	Tawang Monpa	Monpa, Tawang
twn	Twendi	Twendi
two	Tswapong	Tswapong
twp	Ere	Ere
twq	Tasawaq	Tasawaq
twr	Southwestern Tarahumara	Tarahumara, Southwestern
twt	Turiwára	Turiwára
twu	Termanu	Termanu
tww	Tuwari	Tuwari
twx	Tewe	Tewe
twy	Tawoyan	Tawoyan
txa	Tombonuwo	Tombonuwo
txb	Tokharian B	Tokharian B
txc	Tsetsaut	Tsetsaut
txe	Totoli	Totoli
txg	Tangut	Tangut
txh	Thracian	Thracian
txi	Ikpeng	Ikpeng
txm	Tomini	Tomini
txn	West Tarangan	Tarangan, West
txo	Toto	Toto
txq	Tii	Tii
txr	Tartessian	Tartessian
txs	Tonsea	Tonsea
txt	Citak	Citak
txu	Kayapó	Kayapó
txx	Tatana	Tatana
txy	Tanosy Malagasy	Malagasy, Tanosy
tya	Tauya	Tauya
tye	Kyenga	Kyenga
tyh	O'du	O'du
tyi	Teke-Tsaayi	Teke-Tsaayi
tyj	Tai Do	Tai Do
tyl	Thu Lao	Thu Lao
tyn	Kombai	Kombai
typ	Thaypan	Thaypan
tyr	Tai Daeng	Tai Daeng
tys	Tày Sa Pa	Tày Sa Pa
tyt	Tày Tac	Tày Tac
tyu	Kua	Kua
tyv	Tuvinian	Tuvinian
tyx	Teke-Tyee	Teke-Tyee
tyz	Tày	Tày
tza	Tanzanian Sign Language	Tanzanian Sign Language
tzb	Bachajón Tzeltal	Tzeltal, Bachajón
tzc	Chamula Tzotzil	Tzotzil, Chamula
tze	Chenalhó Tzotzil	Tzotzil, Chenalhó
tzh	Oxchuc Tzeltal	Tzeltal, Oxchuc
tzj	Eastern Tzutujil	Tzutujil, Eastern
tzm	Central Atlas Tamazight	Tamazight, Central Atlas
tzn	Tugun	Tugun
tzo	Venustiano Carranza Tzotzil	Tzotzil, Venustiano Carranza
tzs	San Andrés Larrainzar Tzotzil	Tzotzil, San Andrés Larrainzar
tzt	Western Tzutujil	Tzutujil, Western
tzu	Huixtán Tzotzil	Tzotzil, Huixtán
tzx	Tabriak	Tabriak
tzz	Zinacantán Tzotzil	Tzotzil, Zinacantán
uam	Uamué	Uamué
uan	Kuan	Kuan
uar	Tairuma	Tairuma
uba	Ubang	Ubang
ubi	Ubi	Ubi
ubm	Upper Baram Kenyah	Kenyah, Upper Baram
ubr	Ubir	Ubir
ubu	Umbu-Ungu	Umbu-Ungu
uby	Ubykh	Ubykh
uda	Uda	Uda
ude	Udihe	Udihe
udg	Muduga	Muduga
udi	Udi	Udi
udj	Ujir	Ujir
udl	Wuzlam	Wuzlam
udm	Udmurt	Udmurt
udu	Uduk	Uduk
ues	Kioko	Kioko
ufi	Ufim	Ufim
uga	Ugaritic	Ugaritic
ugb	Kuku-Ugbanh	Kuku-Ugbanh
uge	Ughele	Ughele
ugn	Ugandan Sign Language	Ugandan Sign Language
ugo	Ugong	Ugong
ugy	Uruguayan Sign Language	Uruguayan Sign Language
uha	Uhami	Uhami
uhn	Damal	Damal
uig	Uighur	Uighur
uig	Uyghur	Uyghur
uis	Uisai	Uisai
uiv	Iyive	Iyive
uji	Tanjijili	Tanjijili
uka	Kaburi	Kaburi
ukg	Ukuriguma	Ukuriguma
ukh	Ukhwejo	Ukhwejo
ukl	Ukrainian Sign Language	Ukrainian Sign Language
ukp	Ukpe-Bayobiri	Ukpe-Bayobiri
ukq	Ukwa	Ukwa
ukr	Ukrainian	Ukrainian
uks	Urubú-Kaapor Sign Language	Urubú-Kaapor Sign Language
uku	Ukue	Ukue
ukw	Ukwuani-Aboh-Ndoni	Ukwuani-Aboh-Ndoni
ula	Fungwa	Fungwa
ulb	Ulukwumi	Ulukwumi
ulc	Ulch	Ulch
ulf	Usku	Usku
uli	Ulithian	Ulithian
ulk	Meriam	Meriam
ull	Ullatan	Ullatan
ulm	Ulumanda'	Ulumanda'
uln	Unserdeutsch	Unserdeutsch
uma	Umatilla	Umatilla
umb	Umbundu	Umbundu
umc	Marrucinian	Marrucinian
umd	Umbindhamu	Umbindhamu
umg	Umbuygamu	Umbuygamu
umi	Ukit	Ukit
umm	Umon	Umon
umo	Umotína	Umotína
ump	Umpila	Umpila
umr	Umbugarla	Umbugarla
ums	Pendau	Pendau
umu	Munsee	Munsee
una	North Watut	Watut, North
und	Undetermined	Undetermined
une	Uneme	Uneme
ung	Ngarinyin	Ngarinyin
unk	Enawené-Nawé	Enawené-Nawé
unm	Unami	Unami
unp	Worora	Worora
unz	Unde Kaili	Kaili, Unde
uok	Uokha	Uokha
upi	Umeda	Umeda
upv	Uripiv-Wala-Rano-Atchin	Uripiv-Wala-Rano-Atchin
ura	Urarina	Urarina
urb	Urubú-Kaapor	Urubú-Kaapor
urc	Urningangg	Urningangg
urd	Urdu	Urdu
ure	Uru	Uru
urf	Uradhi	Uradhi
urg	Urigina	Urigina
urh	Urhobo	Urhobo
uri	Urim	Urim
urk	Urak Lawoi'	Urak Lawoi'
url	Urali	Urali
urm	Urapmin	Urapmin
urn	Uruangnirin	Uruangnirin
uro	Ura (Papua New Guinea)	Ura (Papua New Guinea)
urp	Uru-Pa-In	Uru-Pa-In
urr	Lehalurup	Lehalurup
urt	Urat	Urat
uru	Urumi	Urumi
urv	Uruava	Uruava
urw	Sop	Sop
urx	Urimo	Urimo
ury	Orya	Orya
urz	Uru-Eu-Wau-Wau	Uru-Eu-Wau-Wau
usa	Usarufa	Usarufa
ush	Ushojo	Ushojo
usi	Usui	Usui
usk	Usaghade	Usaghade
usp	Uspanteco	Uspanteco
usu	Uya	Uya
uta	Otank	Otank
ute	Ute-Southern Paiute	Ute-Southern Paiute
utp	Amba (Solomon Islands)	Amba (Solomon Islands)
utr	Etulo	Etulo
utu	Utu	Utu
uum	Urum	Urum
uun	Kulon-Pazeh	Kulon-Pazeh
uur	Ura (Vanuatu)	Ura (Vanuatu)
uuu	U	U
uve	West Uvean	Uvean, West
uvh	Uri	Uri
uvl	Lote	Lote
uwa	Kuku-Uwanh	Kuku-Uwanh
uya	Doko-Uyanga	Doko-Uyanga
uzb	Uzbek	Uzbek
uzn	Northern Uzbek	Uzbek, Northern
uzs	Southern Uzbek	Uzbek, Southern
vaa	Vaagri Booli	Vaagri Booli
vae	Vale	Vale
vaf	Vafsi	Vafsi
vag	Vagla	Vagla
vah	Varhadi-Nagpuri	Varhadi-Nagpuri
vai	Vai	Vai
vaj	Vasekela Bushman	Vasekela Bushman
val	Vehes	Vehes
vam	Vanimo	Vanimo
van	Valman	Valman
vao	Vao	Vao
vap	Vaiphei	Vaiphei
var	Huarijio	Huarijio
vas	Vasavi	Vasavi
vau	Vanuma	Vanuma
vav	Varli	Varli
vay	Wayu	Wayu
vbb	Southeast Babar	Babar, Southeast
vec	Venetian	Venetian
ved	Veddah	Veddah
vel	Veluws	Veluws
vem	Vemgo-Mabas	Vemgo-Mabas
ven	Venda	Venda
veo	Ventureño	Ventureño
vep	Veps	Veps
ver	Mom Jango	Mom Jango
vgr	Vaghri	Vaghri
vgt	Flemish Sign Language	Flemish Sign Language
vgt	Vlaamse Gebarentaal	Vlaamse Gebarentaal
vic	Virgin Islands Creole English	Creole English, Virgin Islands
vid	Vidunda	Vidunda
vie	Vietnamese	Vietnamese
vif	Vili	Vili
vig	Viemo	Viemo
vil	Vilela	Vilela
vin	Vinza	Vinza
vis	Vishavan	Vishavan
vit	Viti	Viti
viv	Iduna	Iduna
vka	Kariyarra	Kariyarra
vki	Ija-Zuba	Ija-Zuba
vkj	Kujarge	Kujarge
vkk	Kaur	Kaur
vkl	Kulisusu	Kulisusu
vkm	Kamakan	Kamakan
vko	Kodeoha	Kodeoha
vkp	Korlai Creole Portuguese	Creole Portuguese, Korlai
vkt	Tenggarong Kutai Malay	Malay, Tenggarong Kutai
vku	Kurrama	Kurrama
vky	Kayu Agung	Kayu Agung
vlp	Valpei	Valpei
vlr	Vatrata	Vatrata
vls	Vlaams	Vlaams
vma	Martuyhunira	Martuyhunira
vmb	Mbabaram	Mbabaram
vmc	Juxtlahuaca Mixtec	Mixtec, Juxtlahuaca
vmd	Mudu Koraga	Koraga, Mudu
vme	East Masela	Masela, East
vmf	Mainfränkisch	Mainfränkisch
vmg	Minigir	Minigir
vmh	Maraghei	Maraghei
vmi	Miwa	Miwa
vmj	Ixtayutla Mixtec	Mixtec, Ixtayutla
vmk	Makhuwa-Shirima	Makhuwa-Shirima
vml	Malgana	Malgana
vmm	Mitlatongo Mixtec	Mixtec, Mitlatongo
vmo	Muko-Muko	Muko-Muko
vmp	Soyaltepec Mazatec	Mazatec, Soyaltepec
vmq	Soyaltepec Mixtec	Mixtec, Soyaltepec
vmr	Marenje	Marenje
vms	Moksela	Moksela
vmu	Muluridyi	Muluridyi
vmv	Valley Maidu	Maidu, Valley
vmw	Makhuwa	Makhuwa
vmx	Tamazola Mixtec	Mixtec, Tamazola
vmy	Ayautla Mazatec	Mazatec, Ayautla
vmz	Mazatlán Mazatec	Mazatec, Mazatlán
vnk	Vano	Vano
vnm	Vinmavis	Vinmavis
vnp	Vunapu	Vunapu
vol	Volapük	Volapük
vor	Voro	Voro
vot	Votic	Votic
vrs	Varisi	Varisi
vrt	Burmbar	Burmbar
vsi	Moldova Sign Language	Moldova Sign Language
vsl	Venezuelan Sign Language	Venezuelan Sign Language
vsv	Llengua de signes valenciana	Llengua de signes valenciana
vsv	Valencian Sign Language	Valencian Sign Language
vum	Vumbu	Vumbu
vun	Vunjo	Vunjo
vut	Vute	Vute
waa	Walla Walla	Walla Walla
wab	Wab	Wab
wac	Wasco-Wishram	Wasco-Wishram
wad	Wandamen	Wandamen
wae	Walser	Walser
waf	Wakoná	Wakoná
wag	Wa'ema	Wa'ema
wah	Watubela	Watubela
wai	Wares	Wares
waj	Waffa	Waffa
wal	Walamo	Walamo
wam	Wampanoag	Wampanoag
wan	Wan	Wan
wao	Wappo	Wappo
wap	Wapishana	Wapishana
waq	Wageman	Wageman
war	Waray (Philippines)	Waray (Philippines)
was	Washo	Washo
wat	Kaninuwa	Kaninuwa
wau	Waurá	Waurá
wav	Waka	Waka
waw	Waiwai	Waiwai
wax	Watam	Watam
way	Wayana	Wayana
waz	Wampur	Wampur
wba	Warao	Warao
wbb	Wabo	Wabo
wbe	Waritai	Waritai
wbf	Wara	Wara
wbh	Wanda	Wanda
wbi	Wanji	Wanji
wbj	Alagwa	Alagwa
wbk	Waigali	Waigali
wbl	Wakhi	Wakhi
wbm	Wa	Wa
wbp	Warlpiri	Warlpiri
wbq	Waddar	Waddar
wbr	Wagdi	Wagdi
wbt	Wanman	Wanman
wbv	Wajarri	Wajarri
wbw	Woi	Woi
wca	Yanomámi	Yanomámi
wci	Waci Gbe	Gbe, Waci
wdd	Wandji	Wandji
wdg	Wadaginam	Wadaginam
wdj	Wadjiginy	Wadjiginy
wdu	Wadjigu	Wadjigu
wea	Wewaw	Wewaw
wec	Wè Western	Wè Western
wed	Wedau	Wedau
weh	Weh	Weh
wei	Were	Were
wem	Weme Gbe	Gbe, Weme
weo	North Wemale	Wemale, North
wep	Westphalien	Westphalien
wer	Weri	Weri
wes	Cameroon Pidgin	Pidgin, Cameroon
wet	Perai	Perai
weu	Welaung	Welaung
wew	Wejewa	Wejewa
wfg	Yafi	Yafi
wga	Wagaya	Wagaya
wgg	Wangganguru	Wangganguru
wgi	Wahgi	Wahgi
wgo	Waigeo	Waigeo
wgw	Wagawaga	Wagawaga
wgy	Warrgamay	Warrgamay
wha	Manusela	Manusela
whg	North Wahgi	Wahgi, North
whk	Wahau Kenyah	Kenyah, Wahau
whu	Wahau Kayan	Kayan, Wahau
wib	Southern Toussian	Toussian, Southern
wic	Wichita	Wichita
wie	Wik-Epa	Wik-Epa
wif	Wik-Keyangan	Wik-Keyangan
wig	Wik-Ngathana	Wik-Ngathana
wih	Wik-Me'anha	Wik-Me'anha
wii	Minidien	Minidien
wij	Wik-Iiyanh	Wik-Iiyanh
wik	Wikalkan	Wikalkan
wil	Wilawila	Wilawila
wim	Wik-Mungkan	Wik-Mungkan
win	Ho-Chunk	Ho-Chunk
wir	Wiraféd	Wiraféd
wit	Wintu	Wintu
wiu	Wiru	Wiru
wiv	Muduapa	Muduapa
wiw	Wirangu	Wirangu
wiy	Wiyot	Wiyot
wja	Waja	Waja
wji	Warji	Warji
wka	Kw'adza	Kw'adza
wkb	Kumbaran	Kumbaran
wkd	Wakde	Wakde
wkl	Kalanadi	Kalanadi
wku	Kunduvadi	Kunduvadi
wkw	Wakawaka	Wakawaka
wla	Walio	Walio
wlc	Mwali Comorian	Comorian, Mwali
wlg	Kunbarlang	Kunbarlang
wli	Waioli	Waioli
wlk	Wailaki	Wailaki
wll	Wali (Sudan)	Wali (Sudan)
wlm	Middle Welsh	Welsh, Middle
wln	Walloon	Walloon
wlo	Wolio	Wolio
wlr	Wailapa	Wailapa
wls	Wallisian	Wallisian
wlu	Wuliwuli	Wuliwuli
wlv	Wichí Lhamtés Vejoz	Wichí Lhamtés Vejoz
wlw	Walak	Walak
wlx	Wali (Ghana)	Wali (Ghana)
wly	Waling	Waling
wma	Mawa (Nigeria)	Mawa (Nigeria)
wmb	Wambaya	Wambaya
wmc	Wamas	Wamas
wme	Wambule	Wambule
wmh	Waima'a	Waima'a
wmi	Wamin	Wamin
wmm	Maiwa (Indonesia)	Maiwa (Indonesia)
wmn	Waamwang	Waamwang
wmo	Wom (Papua New Guinea)	Wom (Papua New Guinea)
wms	Wambon	Wambon
wmt	Walmajarri	Walmajarri
wmw	Mwani	Mwani
wnb	Wanambre	Wanambre
wnc	Wantoat	Wantoat
wnd	Wandarang	Wandarang
wne	Waneci	Waneci
wng	Wanggom	Wanggom
wni	Ndzwani Comorian	Comorian, Ndzwani
wnk	Wanukaka	Wanukaka
wnm	Wanggamala	Wanggamala
wno	Wano	Wano
wnp	Wanap	Wanap
wnu	Usan	Usan
woa	Tyaraity	Tyaraity
wob	Wè Northern	Wè Northern
woc	Wogeo	Wogeo
wod	Wolani	Wolani
woe	Woleaian	Woleaian
wof	Gambian Wolof	Wolof, Gambian
wog	Wogamusin	Wogamusin
woi	Kamang	Kamang
wok	Longto	Longto
wol	Wolof	Wolof
wom	Wom (Nigeria)	Wom (Nigeria)
won	Wongo	Wongo
woo	Manombai	Manombai
wor	Woria	Woria
wos	Hanga Hundi	Hanga Hundi
wow	Wawonii	Wawonii
woy	Weyto	Weyto
wpc	Maco	Maco
wra	Warapu	Warapu
wrb	Warluwara	Warluwara
wrd	Warduji	Warduji
wre	Ware	Ware
wrg	Warungu	Warungu
wrh	Wiradhuri	Wiradhuri
wri	Wariyangga	Wariyangga
wrl	Warlmanpa	Warlmanpa
wrm	Warumungu	Warumungu
wrn	Warnang	Warnang
wrp	Waropen	Waropen
wrr	Wardaman	Wardaman
wrs	Waris	Waris
wru	Waru	Waru
wrv	Waruna	Waruna
wrw	Gugu Warra	Gugu Warra
wrx	Wae Rana	Wae Rana
wry	Merwari	Merwari
wrz	Waray (Australia)	Waray (Australia)
wsa	Warembori	Warembori
wsi	Wusi	Wusi
wsk	Waskia	Waskia
wsr	Owenia	Owenia
wss	Wasa	Wasa
wsu	Wasu	Wasu
wsv	Wotapuri-Katarqalai	Wotapuri-Katarqalai
wtf	Dumpu	Dumpu
wti	Berta	Berta
wtk	Watakataui	Watakataui
wtm	Mewati	Mewati
wtw	Wotu	Wotu
wua	Wikngenchera	Wikngenchera
wub	Wunambal	Wunambal
wud	Wudu	Wudu
wuh	Wutunhua	Wutunhua
wul	Silimo	Silimo
wum	Wumbvu	Wumbvu
wun	Bungu	Bungu
wur	Wurrugu	Wurrugu
wut	Wutung	Wutung
wuu	Wu Chinese	Chinese, Wu
wuv	Wuvulu-Aua	Wuvulu-Aua
wux	Wulna	Wulna
wuy	Wauyai	Wauyai
wwa	Waama	Waama
wwo	Wetamut	Wetamut
wwr	Warrwa	Warrwa
www	Wawa	Wawa
wxa	Waxianghua	Waxianghua
wya	Wyandot	Wyandot
wyb	Wangaaybuwan-Ngiyambaa	Wangaaybuwan-Ngiyambaa
wym	Wymysorys	Wymysorys
wyr	Wayoró	Wayoró
wyy	Western Fijian	Fijian, Western
xaa	Andalusian Arabic	Arabic, Andalusian
xab	Sambe	Sambe
xac	Kachari	Kachari
xad	Adai	Adai
xae	Aequian	Aequian
xag	Aghwan	Aghwan
xah	Kahayan	Kahayan
xai	Kaimbé	Kaimbé
xal	Kalmyk	Kalmyk
xal	Oirat	Oirat
xam	/Xam	/Xam
xan	Xamtanga	Xamtanga
xao	Khao	Khao
xap	Apalachee	Apalachee
xaq	Aquitanian	Aquitanian
xar	Karami	Karami
xas	Kamas	Kamas
xat	Katawixi	Katawixi
xau	Kauwera	Kauwera
xav	Xavánte	Xavánte
xaw	Kawaiisu	Kawaiisu
xay	Kayan Mahakam	Kayan Mahakam
xba	Kamba (Brazil)	Kamba (Brazil)
xbc	Bactrian	Bactrian
xbi	Kombio	Kombio
xbm	Middle Breton	Breton, Middle
xbo	Bolgarian	Bolgarian
xbr	Kambera	Kambera
xbw	Kambiwá	Kambiwá
xbx	Kabixí	Kabixí
xcb	Cumbric	Cumbric
xcc	Camunic	Camunic
xce	Celtiberian	Celtiberian
xcg	Cisalpine Gaulish	Gaulish, Cisalpine
xch	Chemakum	Chemakum
xcl	Classical Armenian	Armenian, Classical
xcm	Comecrudo	Comecrudo
xcn	Cotoname	Cotoname
xco	Chorasmian	Chorasmian
xcr	Carian	Carian
xct	Classical Tibetan	Tibetan, Classical
xcu	Curonian	Curonian
xcv	Chuvantsy	Chuvantsy
xcw	Coahuilteco	Coahuilteco
xcy	Cayuse	Cayuse
xdc	Dacian	Dacian
xdm	Edomite	Edomite
xdy	Malayic Dayak	Dayak, Malayic
xeb	Eblan	Eblan
xed	Hdi	Hdi
xeg	//Xegwi	//Xegwi
xel	Kelo	Kelo
xem	Kembayan	Kembayan
xep	Epi-Olmec	Epi-Olmec
xer	Xerénte	Xerénte
xes	Kesawai	Kesawai
xet	Xetá	Xetá
xeu	Keoru-Ahia	Keoru-Ahia
xfa	Faliscan	Faliscan
xga	Galatian	Galatian
xgf	Gabrielino-Fernandeño	Gabrielino-Fernandeño
xgl	Galindan	Galindan
xgr	Garza	Garza
xha	Harami	Harami
xhc	Hunnic	Hunnic
xhd	Hadrami	Hadrami
xhe	Khetrani	Khetrani
xho	Xhosa	Xhosa
xhr	Hernican	Hernican
xht	Hattic	Hattic
xhu	Hurrian	Hurrian
xhv	Khua	Khua
xia	Xiandao	Xiandao
xib	Iberian	Iberian
xii	Xiri	Xiri
xil	Illyrian	Illyrian
xin	Xinca	Xinca
xip	Xipináwa	Xipináwa
xir	Xiriâna	Xiriâna
xiv	Indus Valley Language	Indus Valley Language
xiy	Xipaya	Xipaya
xka	Kalkoti	Kalkoti
xkb	Manigri-Kambolé Ede Nago	Ede Nago, Manigri-Kambolé
xkc	Kho'ini	Kho'ini
xkd	Mendalam Kayan	Kayan, Mendalam
xke	Kereho	Kereho
xkf	Khengkha	Khengkha
xkg	Kagoro	Kagoro
xkh	Karahawyana	Karahawyana
xki	Kenyan Sign Language	Kenyan Sign Language
xkj	Kajali	Kajali
xkk	Kaco'	Kaco'
xkl	Kelinyau Kenyah	Kenyah, Kelinyau
xkm	Mahakam Kenyah	Kenyah, Mahakam
xkn	Kayan River Kayan	Kayan, Kayan River
xko	Kiorr	Kiorr
xkp	Kabatei	Kabatei
xkq	Koroni	Koroni
xkr	Xakriabá	Xakriabá
xks	Kumbewaha	Kumbewaha
xkt	Kantosi	Kantosi
xku	Kaamba	Kaamba
xkv	Kgalagadi	Kgalagadi
xkw	Kembra	Kembra
xkx	Karore	Karore
xky	Western Kenyah	Kenyah, Western
xkz	Kurtokha	Kurtokha
xla	Kamula	Kamula
xlb	Loup B	Loup B
xlc	Lycian	Lycian
xld	Lydian	Lydian
xle	Lemnian	Lemnian
xlg	Ligurian (Ancient)	Ligurian (Ancient)
xli	Liburnian	Liburnian
xln	Alanic	Alanic
xlo	Loup A	Loup A
xlp	Lepontic	Lepontic
xls	Lusitanian	Lusitanian
xlu	Cuneiform Luwian	Luwian, Cuneiform
xly	Elymian	Elymian
xma	Mushungulu	Mushungulu
xmb	Mbonga	Mbonga
xmc	Makhuwa-Marrevone	Makhuwa-Marrevone
xmd	Mbedam	Mbedam
xme	Median	Median
xmf	Mingrelian	Mingrelian
xmg	Mengaka	Mengaka
xmh	Kuku-Muminh	Kuku-Muminh
xmj	Majera	Majera
xmk	Ancient Macedonian	Macedonian, Ancient
xml	Malaysian Sign Language	Malaysian Sign Language
xmm	Manado Malay	Malay, Manado
xmn	Manichaean Middle Persian	Persian, Manichaean Middle
xmo	Morerebi	Morerebi
xmp	Kuku-Mu'inh	Kuku-Mu'inh
xmq	Kuku-Mangk	Kuku-Mangk
xmr	Meroitic	Meroitic
xms	Moroccan Sign Language	Moroccan Sign Language
xmt	Matbat	Matbat
xmu	Kamu	Kamu
xmv	Antankarana Malagasy	Malagasy, Antankarana
xmw	Tsimihety Malagasy	Malagasy, Tsimihety
xmx	Maden	Maden
xmy	Mayaguduna	Mayaguduna
xmz	Mori Bawah	Mori Bawah
xna	Ancient North Arabian	North Arabian, Ancient
xnb	Kanakanabu	Kanakanabu
xng	Middle Mongolian	Mongolian, Middle
xnh	Kuanhua	Kuanhua
xnn	Northern Kankanay	Kankanay, Northern
xno	Anglo-Norman	Anglo-Norman
xnr	Kangri	Kangri
xns	Kanashi	Kanashi
xoc	O'chi'chi'	O'chi'chi'
xod	Kokoda	Kokoda
xog	Soga	Soga
xoi	Kominimung	Kominimung
xok	Xokleng	Xokleng
xom	Komo (Sudan)	Komo (Sudan)
xon	Konkomba	Konkomba
xoo	Xukurú	Xukurú
xop	Kopar	Kopar
xor	Korubo	Korubo
xow	Kowaki	Kowaki
xpc	Pecheneg	Pecheneg
xpe	Liberia Kpelle	Kpelle, Liberia
xpg	Phrygian	Phrygian
xpi	Pictish	Pictish
xpk	Kulina Pano	Pano, Kulina
xpm	Pumpokol	Pumpokol
xpn	Kapinawá	Kapinawá
xpo	Pochutec	Pochutec
xpp	Puyo-Paekche	Puyo-Paekche
xpr	Parthian	Parthian
xps	Pisidian	Pisidian
xpu	Punic	Punic
xpy	Puyo	Puyo
xqa	Karakhanid	Karakhanid
xqt	Qatabanian	Qatabanian
xra	Krahô	Krahô
xrb	Eastern Karaboro	Karaboro, Eastern
xre	Kreye	Kreye
xri	Krikati-Timbira	Krikati-Timbira
xrm	Armazic	Armazic
xrn	Arin	Arin
xrr	Raetic	Raetic
xrt	Aranama-Tamique	Aranama-Tamique
xru	Marriammu	Marriammu
xrw	Karawa	Karawa
xsa	Sabaean	Sabaean
xsb	Tinà Sambal	Sambal, Tinà
xsc	Scythian	Scythian
xsd	Sidetic	Sidetic
xse	Sempan	Sempan
xsh	Shamang	Shamang
xsi	Sio	Sio
xsj	Subi	Subi
xsk	Sakan	Sakan
xsl	South Slavey	Slavey, South
xsm	Kasem	Kasem
xsn	Sanga (Nigeria)	Sanga (Nigeria)
xso	Solano	Solano
xsp	Silopi	Silopi
xsq	Makhuwa-Saka	Makhuwa-Saka
xsr	Sherpa	Sherpa
xss	Assan	Assan
xst	Silt'e	Silt'e
xsu	Sanumá	Sanumá
xsv	Sudovian	Sudovian
xsy	Saisiyat	Saisiyat
xta	Alcozauca Mixtec	Mixtec, Alcozauca
xtb	Chazumba Mixtec	Mixtec, Chazumba
xtc	Katcha-Kadugli-Miri	Katcha-Kadugli-Miri
xtd	Diuxi-Tilantongo Mixtec	Mixtec, Diuxi-Tilantongo
xte	Ketengban	Ketengban
xtg	Transalpine Gaulish	Gaulish, Transalpine
xti	Sinicahua Mixtec	Mixtec, Sinicahua
xtj	San Juan Teita Mixtec	Mixtec, San Juan Teita
xtl	Tijaltepec Mixtec	Mixtec, Tijaltepec
xtm	Magdalena Peñasco Mixtec	Mixtec, Magdalena Peñasco
xtn	Northern Tlaxiaco Mixtec	Mixtec, Northern Tlaxiaco
xto	Tokharian A	Tokharian A
xtp	San Miguel Piedras Mixtec	Mixtec, San Miguel Piedras
xtq	Tumshuqese	Tumshuqese
xtr	Early Tripuri	Tripuri, Early
xts	Sindihui Mixtec	Mixtec, Sindihui
xtt	Tacahua Mixtec	Mixtec, Tacahua
xtu	Cuyamecalco Mixtec	Mixtec, Cuyamecalco
xty	Yoloxochitl Mixtec	Mixtec, Yoloxochitl
xtz	Tasmanian	Tasmanian
xua	Alu Kurumba	Kurumba, Alu
xub	Betta Kurumba	Kurumba, Betta
xuf	Kunfal	Kunfal
xug	Kunigami	Kunigami
xuj	Jennu Kurumba	Kurumba, Jennu
xum	Umbrian	Umbrian
xuo	Kuo	Kuo
xup	Upper Umpqua	Umpqua, Upper
xur	Urartian	Urartian
xut	Kuthant	Kuthant
xuu	Kxoe	Kxoe
xve	Venetic	Venetic
xvi	Kamviri	Kamviri
xvn	Vandalic	Vandalic
xvo	Volscian	Volscian
xvs	Vestinian	Vestinian
xwa	Kwaza	Kwaza
xwc	Woccon	Woccon
xwe	Xwela Gbe	Gbe, Xwela
xwg	Kwegu	Kwegu
xwl	Western Xwla Gbe	Gbe, Western Xwla
xwo	Written Oirat	Oirat, Written
xwr	Kwerba Mamberamo	Kwerba Mamberamo
xxk	Ke'o	Ke'o
xzh	Zhang-Zhung	Zhang-Zhung
xzm	Zemgalian	Zemgalian
xzp	Ancient Zapotec	Zapotec, Ancient
yaa	Yaminahua	Yaminahua
yab	Yuhup	Yuhup
yac	Pass Valley Yali	Yali, Pass Valley
yad	Yagua	Yagua
yae	Pumé	Pumé
yaf	Yaka (Democratic Republic of Congo)	Yaka (Democratic Republic of Congo)
yag	Yámana	Yámana
yah	Yazgulyam	Yazgulyam
yai	Yagnobi	Yagnobi
yaj	Banda-Yangere	Banda-Yangere
yak	Yakima	Yakima
yal	Yalunka	Yalunka
yam	Yamba	Yamba
yao	Yao	Yao
yap	Yapese	Yapese
yaq	Yaqui	Yaqui
yar	Yabarana	Yabarana
yas	Nugunu (Cameroon)	Nugunu (Cameroon)
yat	Yambeta	Yambeta
yau	Yuwana	Yuwana
yav	Yangben	Yangben
yaw	Yawalapití	Yawalapití
yax	Yauma	Yauma
yay	Agwagwune	Agwagwune
yaz	Lokaa	Lokaa
yba	Yala	Yala
ybb	Yemba	Yemba
ybd	Yangbye	Yangbye
ybe	West Yugur	Yugur, West
ybh	Yakha	Yakha
ybi	Yamphu	Yamphu
ybj	Hasha	Hasha
ybl	Yukuben	Yukuben
ybm	Yaben	Yaben
ybn	Yabaâna	Yabaâna
ybo	Yabong	Yabong
ybx	Yawiyo	Yawiyo
yby	Yaweyuha	Yaweyuha
ycl	Central Yi	Yi, Central
ycn	Yucuna	Yucuna
ydd	Eastern Yiddish	Yiddish, Eastern
yde	Yangum Dey	Yangum Dey
ydg	Yidgha	Yidgha
ydk	Yoidik	Yoidik
yds	Yiddish Sign Language	Yiddish Sign Language
yea	Ravula	Ravula
yec	Yeniche	Yeniche
yee	Yimas	Yimas
yei	Yeni	Yeni
yej	Yevanic	Yevanic
yel	Yela	Yela
yen	Yendang	Yendang
yer	Tarok	Tarok
yes	Yeskwa	Yeskwa
yet	Yetfa	Yetfa
yeu	Yerukula	Yerukula
yev	Yapunda	Yapunda
yey	Yeyi	Yeyi
ygl	Yangum Gel	Yangum Gel
ygm	Yagomi	Yagomi
ygr	Yagaria	Yagaria
ygw	Yagwoia	Yagwoia
yhd	Judeo-Iraqi Arabic	Arabic, Judeo-Iraqi
yia	Yinggarda	Yinggarda
yid	Yiddish	Yiddish
yif	Ache Yi	Yi, Ache
yig	Guizhou Yi	Yi, Guizhou
yih	Western Yiddish	Yiddish, Western
yii	Yidiny	Yidiny
yij	Yindjibarndi	Yindjibarndi
yik	Xishan Lalu Yi	Yi, Xishan Lalu
yil	Yindjilandji	Yindjilandji
yim	Yimchungru Naga	Naga, Yimchungru
yin	Yinchia	Yinchia
yio	Dayao Yi	Yi, Dayao
yip	Poluo Yi	Yi, Poluo
yiq	Miqie Yi	Yi, Miqie
yir	North Awyu	Awyu, North
yis	Yis	Yis
yit	Eastern Lalu Yi	Yi, Eastern Lalu
yiu	Awu Yi	Yi, Awu
yiv	Eshan-Xinping Yi	Yi, Eshan-Xinping
yix	Axi Yi	Yi, Axi
yiy	Yir Yoront	Yir Yoront
yiz	Azhe Yi	Yi, Azhe
yka	Yakan	Yakan
ykg	Northern Yukaghir	Yukaghir, Northern
yki	Yoke	Yoke
ykk	Yakaikeke	Yakaikeke
ykm	Yakamul	Yakamul
yko	Yasa	Yasa
ykr	Yekora	Yekora
yky	Yakoma	Yakoma
yla	Yaul	Yaul
yle	Yele	Yele
ylg	Yelogu	Yelogu
yli	Angguruk Yali	Yali, Angguruk
yll	Yil	Yil
ylm	Limi Yi	Yi, Limi
ylo	Naluo Yi	Yi, Naluo
ylr	Yalarnnga	Yalarnnga
ylu	Aribwaung	Aribwaung
yly	Nyâlayu	Nyâlayu
yma	Yamphe	Yamphe
ymb	Yambes	Yambes
yme	Yameo	Yameo
ymg	Yamongeri	Yamongeri
ymh	Mili Yi	Yi, Mili
ymj	Muji Yi	Yi, Muji
ymk	Makwe	Makwe
yml	Iamalele	Iamalele
ymm	Maay	Maay
ymn	Yamna	Yamna
ymo	Yangum Mon	Yangum Mon
ymp	Yamap	Yamap
ymr	Malasar	Malasar
yms	Mysian	Mysian
ymt	Mator-Taygi-Karagas	Mator-Taygi-Karagas
ynd	Yandruwandha	Yandruwandha
yng	Yango	Yango
ynh	Yangho	Yangho
ynk	Naukan Yupik	Yupik, Naukan
ynl	Yangulam	Yangulam
ynn	Yana	Yana
yno	Yong	Yong
yns	Yansi	Yansi
ynu	Yahuna	Yahuna
yob	Yoba	Yoba
yog	Yogad	Yogad
yoi	Yonaguni	Yonaguni
yok	Yokuts	Yokuts
yom	Yombe	Yombe
yon	Yonggom	Yonggom
yor	Yoruba	Yoruba
yos	Yos	Yos
yox	Yoron	Yoron
yoy	Yoy	Yoy
ypl	Pula Yi	Yi, Pula
ypw	Puwa Yi	Yi, Puwa
yra	Yerakai	Yerakai
yrb	Yareba	Yareba
yre	Yaouré	Yaouré
yri	Yarí	Yarí
yrk	Nenets	Nenets
yrl	Nhengatu	Nhengatu
yrn	Yerong	Yerong
yrs	Yarsun	Yarsun
yrw	Yarawata	Yarawata
ysc	Yassic	Yassic
ysl	Yugoslavian Sign Language	Yugoslavian Sign Language
ysn	Sani Yi	Yi, Sani
yso	Southeastern Lolo Yi	Yi, Southeastern Lolo
ysp	Southern Lolopho Yi	Yi, Southern Lolopho
ysr	Sirenik Yupik	Yupik, Sirenik
yss	Yessan-Mayo	Yessan-Mayo
yua	Yucatán Maya	Maya, Yucatán
yub	Yugambal	Yugambal
yuc	Yuchi	Yuchi
yud	Judeo-Tripolitanian Arabic	Arabic, Judeo-Tripolitanian
yue	Yue Chinese	Chinese, Yue
yuf	Havasupai-Walapai-Yavapai	Havasupai-Walapai-Yavapai
yug	Yug	Yug
yui	Yurutí	Yurutí
yuj	Karkar-Yuri	Karkar-Yuri
yuk	Yuki	Yuki
yul	Yulu	Yulu
yum	Quechan	Quechan
yun	Bena (Nigeria)	Bena (Nigeria)
yup	Yukpa	Yukpa
yuq	Yuqui	Yuqui
yur	Yurok	Yurok
yus	Chan Santa Cruz Maya	Maya, Chan Santa Cruz
yut	Yopno	Yopno
yuu	Yugh	Yugh
yuw	Yau (Morobe Province)	Yau (Morobe Province)
yux	Southern Yukaghir	Yukaghir, Southern
yuy	East Yugur	Yugur, East
yuz	Yuracare	Yuracare
yva	Yawa	Yawa
yvt	Yavitero	Yavitero
ywa	Kalou	Kalou
ywl	Western Lalu Yi	Yi, Western Lalu
ywm	Wumeng Yi	Yi, Wumeng
ywn	Yawanawa	Yawanawa
ywq	Wuding-Luquan Yi	Yi, Wuding-Luquan
ywr	Yawuru	Yawuru
ywt	Western Yi	Yi, Western
ywu	Wusa Yi	Yi, Wusa
yww	Yawarawarga	Yawarawarga
yym	Yuanjiang-Mojiang Yi	Yi, Yuanjiang-Mojiang
yyu	Yau (Sandaun Province)	Yau (Sandaun Province)
zaa	Sierra de Juárez Zapotec	Zapotec, Sierra de Juárez
zab	San Juan Guelavía Zapotec	Zapotec, San Juan Guelavía
zac	Ocotlán Zapotec	Zapotec, Ocotlán
zad	Cajonos Zapotec	Zapotec, Cajonos
zae	Yareni Zapotec	Zapotec, Yareni
zaf	Ayoquesco Zapotec	Zapotec, Ayoquesco
zag	Zaghawa	Zaghawa
zah	Zangwal	Zangwal
zai	Isthmus Zapotec	Zapotec, Isthmus
zaj	Zaramo	Zaramo
zak	Zanaki	Zanaki
zal	Zauzou	Zauzou
zam	Miahuatlán Zapotec	Zapotec, Miahuatlán
zao	Ozolotepec Zapotec	Zapotec, Ozolotepec
zap	Zapotec	Zapotec
zaq	Aloápam Zapotec	Zapotec, Aloápam
zar	Rincón Zapotec	Zapotec, Rincón
zas	Santo Domingo Albarradas Zapotec	Zapotec, Santo Domingo Albarradas
zat	Tabaa Zapotec	Zapotec, Tabaa
zau	Zangskari	Zangskari
zav	Yatzachi Zapotec	Zapotec, Yatzachi
zaw	Mitla Zapotec	Zapotec, Mitla
zax	Xadani Zapotec	Zapotec, Xadani
zay	Zayse-Zergulla	Zayse-Zergulla
zaz	Zari	Zari
zbl	Bliss	Bliss
zbl	Blissymbolics	Blissymbolics
zbl	Blissymbols	Blissymbols
zca	Coatecas Altas Zapotec	Zapotec, Coatecas Altas
zdj	Ngazidja Comorian	Comorian, Ngazidja
zea	Zeeuws	Zeeuws
zeg	Zenag	Zenag
zen	Zenaga	Zenaga
zga	Kinga	Kinga
zgr	Magori	Magori
zha	Chuang	Chuang
zha	Zhuang	Zhuang
zhb	Zhaba	Zhaba
zhd	Dai Zhuang	Zhuang, Dai
zhi	Zhire	Zhire
zhn	Nong Zhuang	Zhuang, Nong
zho	Chinese	Chinese
zhw	Zhoa	Zhoa
zia	Zia	Zia
zib	Zimbabwe Sign Language	Zimbabwe Sign Language
zik	Zimakani	Zimakani
zim	Mesme	Mesme
zin	Zinza	Zinza
zir	Ziriya	Ziriya
ziw	Zigula	Zigula
ziz	Zizilivakan	Zizilivakan
zka	Kaimbulawa	Kaimbulawa
zkb	Koibal	Koibal
zkg	Koguryo	Koguryo
zkh	Khorezmian	Khorezmian
zkk	Karankawa	Karankawa
zko	Kott	Kott
zkp	São Paulo Kaingáng	Kaingáng, São Paulo
zkr	Zakhring	Zakhring
zkt	Kitan	Kitan
zku	Kaurna	Kaurna
zkv	Krevinian	Krevinian
zkz	Khazar	Khazar
zma	Manda (Australia)	Manda (Australia)
zmb	Zimba	Zimba
zmc	Margany	Margany
zmd	Maridan	Maridan
zme	Mangerr	Mangerr
zmf	Mfinu	Mfinu
zmg	Marti Ke	Marti Ke
zmh	Makolkol	Makolkol
zmi	Negeri Sembilan Malay	Negeri Sembilan Malay
zmj	Maridjabin	Maridjabin
zmk	Mandandanyi	Mandandanyi
zml	Madngele	Madngele
zmm	Marimanindji	Marimanindji
zmn	Mbangwe	Mbangwe
zmo	Molo	Molo
zmp	Mpuono	Mpuono
zmq	Mituku	Mituku
zmr	Maranunggu	Maranunggu
zms	Mbesa	Mbesa
zmt	Maringarr	Maringarr
zmu	Muruwari	Muruwari
zmv	Mbariman-Gudhinma	Mbariman-Gudhinma
zmw	Mbo (Democratic Republic of Congo)	Mbo (Democratic Republic of Congo)
zmx	Bomitaba	Bomitaba
zmy	Mariyedi	Mariyedi
zmz	Mbandja	Mbandja
zna	Zan Gula	Zan Gula
zne	Zande (individual language)	Zande (individual language)
zng	Mang	Mang
znk	Manangkari	Manangkari
zns	Mangas	Mangas
zoc	Copainalá Zoque	Zoque, Copainalá
zoh	Chimalapa Zoque	Zoque, Chimalapa
zom	Zou	Zou
zoo	Asunción Mixtepec Zapotec	Zapotec, Asunción Mixtepec
zoq	Tabasco Zoque	Zoque, Tabasco
zor	Rayón Zoque	Zoque, Rayón
zos	Francisco León Zoque	Zoque, Francisco León
zpa	Lachiguiri Zapotec	Zapotec, Lachiguiri
zpb	Yautepec Zapotec	Zapotec, Yautepec
zpc	Choapan Zapotec	Zapotec, Choapan
zpd	Southeastern Ixtlán Zapotec	Zapotec, Southeastern Ixtlán
zpe	Petapa Zapotec	Zapotec, Petapa
zpf	San Pedro Quiatoni Zapotec	Zapotec, San Pedro Quiatoni
zpg	Guevea De Humboldt Zapotec	Zapotec, Guevea De Humboldt
zph	Totomachapan Zapotec	Zapotec, Totomachapan
zpi	Santa María Quiegolani Zapotec	Zapotec, Santa María Quiegolani
zpj	Quiavicuzas Zapotec	Zapotec, Quiavicuzas
zpk	Tlacolulita Zapotec	Zapotec, Tlacolulita
zpl	Lachixío Zapotec	Zapotec, Lachixío
zpm	Mixtepec Zapotec	Zapotec, Mixtepec
zpn	Santa Inés Yatzechi Zapotec	Zapotec, Santa Inés Yatzechi
zpo	Amatlán Zapotec	Zapotec, Amatlán
zpp	El Alto Zapotec	Zapotec, El Alto
zpq	Zoogocho Zapotec	Zapotec, Zoogocho
zpr	Santiago Xanica Zapotec	Zapotec, Santiago Xanica
zps	Coatlán Zapotec	Zapotec, Coatlán
zpt	San Vicente Coatlán Zapotec	Zapotec, San Vicente Coatlán
zpu	Yalálag Zapotec	Zapotec, Yalálag
zpv	Chichicapan Zapotec	Zapotec, Chichicapan
zpw	Zaniza Zapotec	Zapotec, Zaniza
zpx	San Baltazar Loxicha Zapotec	Zapotec, San Baltazar Loxicha
zpy	Mazaltepec Zapotec	Zapotec, Mazaltepec
zpz	Texmelucan Zapotec	Zapotec, Texmelucan
zra	Kara (Korea)	Kara (Korea)
zrg	Mirgan	Mirgan
zrn	Zirenkel	Zirenkel
zro	Záparo	Záparo
zrp	Zarphatic	Zarphatic
zrs	Mairasi	Mairasi
zsk	Kaskean	Kaskean
zsl	Zambian Sign Language	Zambian Sign Language
zsr	Southern Rincon Zapotec	Zapotec, Southern Rincon
zte	Elotepec Zapotec	Zapotec, Elotepec
ztg	Xanaguía Zapotec	Zapotec, Xanaguía
ztl	Lapaguía-Guivini Zapotec	Zapotec, Lapaguía-Guivini
ztm	San Agustín Mixtepec Zapotec	Zapotec, San Agustín Mixtepec
ztn	Santa Catarina Albarradas Zapotec	Zapotec, Santa Catarina Albarradas
ztp	Loxicha Zapotec	Zapotec, Loxicha
ztq	Quioquitani-Quierí Zapotec	Zapotec, Quioquitani-Quierí
zts	Tilquiapan Zapotec	Zapotec, Tilquiapan
ztt	Tejalapan Zapotec	Zapotec, Tejalapan
ztu	Güilá Zapotec	Zapotec, Güilá
ztx	Zaachila Zapotec	Zapotec, Zaachila
zty	Yatee Zapotec	Zapotec, Yatee
zua	Zeem	Zeem
zuh	Tokano	Tokano
zul	Zulu	Zulu
zum	Kumzari	Kumzari
zun	Zuni	Zuni
zuy	Zumaya	Zumaya
zwa	Zay	Zay
zxx	No linguistic content	No linguistic content
zyg	Yang Zhuang	Zhuang, Yang
zyn	Yongnan Zhuang	Zhuang, Yongnan
zyp	Zyphe	Zyphe
zza	Dimili	Dimili
zza	Dimli	Dimli
zza	Kirdki	Kirdki
zza	Kirmanjki	Kirmanjki
zza	Zaza	Zaza
zza	Zazaki	Zazaki
zzj	Zuojiang Zhuang	Zhuang, Zuojiang