aar	Afaraf
abk	Аҧсуа
ace	Aceh
ada	adangbɛ
ady	адыгэбзэ, адыгабзэ
afr	Afrikaans
ain	アイヌ イタㇰ(イタッㇰ) or ainu itak
akk	akkadû, lišānum akkadītum
alb	Shqip
alt	алтай тили
amh	አማርኛ
ang	Englisc
ara	العربية
arc	ܐܪܡܝܐ
arg	Aragonés
arm	Հայերեն լեզու
arn	mapudungun, mapuchedungun 
arp	Hinóno'eitíít
asm	অসমীয়া
ast	asturianu
ava	авар мацӀ, магӀарул мацӀ
ave	avesta
awa	अवधी
aym	aymar aru
aze	Azərbaycanca
bak	башҡорт теле
bal	بلوچی
bam	bamanankan
ban	Basa Bali
baq	euskara
bas	ɓasaá
bej	بداوية
bel	Беларуская мова
bem	ichiBemba
ben	বাংলা
bho	भोजपुरी
bin	Edo
bis	Bislama
bla	siksiká, ᓱᖽᐧᖿ
bos	bosanski jezik
bra	ब्रज भाषा, Brij Bhasha
bre	brezhoneg
bua	буряад хэлэн
bug	ᨅᨔ ᨕᨘᨁᨗ
bul	български език
bur	ျမန္မာစာ
byn	ብሊና
cad	Hasí:nay
cat	català
ceb	Sinugboanon
cha	Chamoru
che	нохчийн мотт
chg	جغتای
chi	中文
chm	марий йылме
cho	Chahta Anumpa
chp	Dëne Sųłiné, ᑌᓀᓲᒢᕄᓀ
chr	ᏣᎳᎩ
chu	ѩзыкъ словѣньскъ
chv	чӑваш чӗлхи
chy	Tsêhést
cop	ⲙⲉⲧⲛ̀ⲣⲉⲙⲛ̀ⲭⲏⲙⲓ
cor	Kernewek
cos	corsu, lingua corsa
cre	ᓀᐦᐃᔭᐍᐏᐣ
crh	qırımtatar tili, къырымтатар тили
csb	kaszëbsczi jãzëk
cze	česky, čeština
dak	Lakhota
dan	dansk
dar	дарган мез
del	Lënape
dgr	Tłįchǫ
din	Thuɔŋjäŋ
div	ދިވެހިބަސ
doi	डोगरी
dsb	dolnoserbski
dut	Nederlands
dyu	Julakan
dzo	རྫོང་ཁ
eng	English
epo	Esperanto
est	eesti keel
ewe	Ɛʋɛgbɛ
fao	føroyskt
fij	vosa Vakaviti
fin	suomi, suomen kieli
fon	Fɔngbe
fre	français
frs	Seeltersk Fräisk, Seeltersk, Fräisk
fry	frysk
ful	Fulfulde, Pulaar, Pular
fur	furlan
gaa	Gã
geo	ქართული ენა (''kartuli ena'')
ger	Deutsch
gez	ግዕዝ
gil	taetae ni Kiribati
gla	Gàidhlig
gle	Gaeilge
glg	Galego
glv	Gaelg, Manninagh
gmh	diutisk
goh	diutisc
gon	Gōndi
got	𐌲𐌿𐍄𐌹𐍃𐌺
grc	Ἑλληνικά
gre	Ελληνικά
grn	Avañe'ẽ
gsw	Alemannisch, Schwyzerdütsch
guj	ગુજરાતી
hai	X̲aat Kíl
hat	Kreyòl ayisyen
hau	Hausancī, هَوُسَ
haw	‘Ōlelo Hawai‘i
heb	עִבְרִית, עברית
her	Otjiherero
hil	Ilonggo
hin	हिन्दी
hmn	Hmoob
hmo	Hiri Motu
hsb	hornjoserbsce
hun	Magyar
hup	Na:tinixwe Mixine:whe
ibo	Igbo
ice	íslenska
ido	Ido
iii	ꆇꉙ
iku	ᐃᓄᒃᑎᑐᑦ
ile	Interlingue
ina	interlingua
ind	Bahasa Indonesia
inh	гӀалгӀай мотт
ipk	Iñupiaq, Iñupiatun
ita	italiano
jav	basa Jawa
jbo	lojban
jpn	日本語
kaa	қарақалпақ тили
kab	Taqbaylit
kac	Jingpho, Marip
kal	kalaallisut, kalaallit oqaasii
kan	ಕನ್ನಡ
kas	कॉशुर, کٲشُر
kaw	Bhāṣa Kawi
kaz	Қазақ тілі
kbd	къэбэрдеибзэ
kha	Khasi
kik	Gĩkũyũ
kin	kinyaRwanda
kir	кыргыз тили
kok	कोंकणी
kom	коми кыв
kon	Kikongo
kor	한국어
kos	Kosrae
kpe	kpele
krc	къарачай-малкъар тил
krl	karjalan kieli
kum	Кумык
kur	Kurdî
kut	Ktunaxa
lad	ג'ודיאו-איספאנייול
lah	ਲਹਿੰਦੀ
lao	ພາສາລາວ
lat	latine, lingua latina
lav	latviešu valoda
lez	лезги чӀал
lim	Limburgs
lin	lingála
lit	lietuvių kalba
loz	siLozi
ltz	Lëtzebuergesch
lua	lwaà:
lug	Luganda
lun	chiLunda
luo	Dholuo
mac	македонски јазик
mah	Kajin M̧ajeļ
mai	मैथिली
mal	മലയാളം
mao	te reo Māori
mar	मराठी
mas	ɔl Maa
may	bahasa Melayu, بهاس ملايو
mdf	мокшень кяль
men	Mɛnde
mga	Gaoidhealg
mic	Míkmaq, Mi'gmaq
min	Baso Minangkabau
mlg	Malagasy fiteny
mlt	Malti
mnc	ᠮᠠᠨᠵᡠ ᡤᡳᠰᡠᠨ ᠪᡝ
mni	মৈইতৈইলোন
moh	Kanien’keha
mon	монгол хэл
mos	Mòoré
mus	Maskoki, Mvskokē empunakv
mwl	Lhéngua Mirandesa
mwr	मारवाड़ी
myv	эрзянь кель
nah	nāhuatl, nawatlahtolli
nap	napulitano
nau	Ekakairũ Naoero
nav	Diné bizaad, Dinékʼehǰí
nbl	Ndébélé
nde	isiNdebele
ndo	Owambo
nds	Nederdüütsch, Plattdüütsch
nep	नेपाली
new	Nepal Bhasa
niu	ko e vagahau Niuē, faka-Niue
nno	nynorsk
nob	bokmål
nog	ногай тили
non	norskr
nor	norsk
nso	sePêdi
nya	chiCheŵa, chinyanja
nym	Kinyamwezi
nyn	Lounyankolé
nyo	Runyoro
oci	occitan
oji	ᐊᓂᔑᓇᐯᒧᐏᐣ
ori	ଓଡ଼ିଆ
orm	Afaan Oromoo
oss	ирон ӕвзаг
pam	Kapampangan
pan	ਪੰਜਾਬੀ, پنجابی
pap	Papiamentu
pau	tekoi ra Belau
per	فارسی
pli	पालि
pol	polski
por	português
pus	پښت
que	Runa Simi, Kichwa
raj	राजस्थानी
rap	rapanui, pepito ote henua
roh	rumantsch grischun
rom	romani ćhib, Romani šib, Romanó
rum	română
run	kiRundi
rup	Armãneashce, Armãneashti, Limba armãneascã
rus	русский язык
sag	yângâ tî sängö
sah	Саха тыла
sam	ארמית, ܐܪܡܝܐ
san	संस्कृतम्
sat	संथाली
scc	српски језик
scn	Sicilianu
sco	Scoats leid, Lallans
scr	hrvatski jezik
sel	шӧльӄумыт әты
sga	Goídelc
hbs	Српскохрватски / Srpskohrvatski
sid	Sidámo 'Afó
sin	සිංහල
slo	slovenčina
slv	slovenščina
sma	saemien giele
sme	sámi, sámegiella
smj	sámegiella
smn	säämegiella
smo	gagana fa'a Samoa
sms	sääʼmǩiõll
sna	chiShona
snd	سنڌي، سندھی, सिन्धी
snk	Soninkanxaane
som	Soomaaliga, af Soomaali
sot	seSotho
spa	español, castellano
srd	sardu
ssw	siSwati
sun	basa Sunda
sux	eme-ĝir
swa	kiswahili
swe	svenska
syr	ܣܘܪܝܝܐ
tah	te reo Tahiti, te reo Māʼohi
tam	தமிழ்
tat	татарча, tatarça, تاتارچا
tel	తెలుగు
tet	Tetun
tgk	тоҷикӣ, تاجیکی
tgl	Tagalog
tha	ภาษาไทย
tib	བོད་ཡིག
tig	Tigré, Khasa
tir	ትግርኛ
tkl	Tokelau
tlh	tlhIngan Hol
tli	Lingít
tmh	Tamajeq, ɫ[ǂ…
tog	chiTonga
ton	faka-Tonga
tpi	Tok Pisin
tsn	seTswana
tso	xiTsonga
tuk	Түркмен
tum	chiTumbuka
tup	Nheengatu
tur	Türkçe
tvl	'gana Tuvalu
tyv	тыва дыл
udm	удмурт кыл
uig	Uyƣurqə, Uyğurçe, ئۇيغۇرچ
ukr	українська мова
umb	úmbúndú
urd	اردو
uzb	O'zbek, Ўзбек, أۇزبېك
ven	tshiVenḓa
vie	Tiếng Việt
vol	Volapük
vot	vaďďa tšeeli
war	Winaray, Lineyte-Samarnon
wel	Cymraeg
wln	walon
wol	Wolof
xal	хальмг келн
xho	isiXhosa
yid	ייִדיש
yor	Yorùbá
zen	Tuḍḍungiyya
zha	Saɯ cueŋƅ, Saw cuengh
zul	isiZulu
zun	Shiwi
